a	a	POSTP
a	a	NOUN
acómpana	acómpana	NOUN
acónquin	acónquin	ADV
acóntema	acóntema	NOUN
ahuá	ahuá	NOUN
ahuábero	ahuábero	NOUN
ahuájora	ahuájora	NOUN
ahuántso	ahuántso	NOUN
ahuápa	ahuápa	NOUN
ahuápishi	ahuápishi	NOUN
ahuátepon	ahuátepon	NOUN
ahuín	ahuín	NOUN
ahuínhati	ahuínhati	VERB[T]
ain	ain	POSTP
ainbobake	ainbobake	NOUN
ainbobaque	ainbobaque	NOUN
ajirica 	ajirica 	NOUN
ajirika	ajirika	NOUN
ajínti	ajínti	NOUN
ajínti 	ajínti 	NOUN
ake	ake	ADV
akéni	akéni	NOUN
akínti	akínti	VERB[T]
akómpana	akómpana	NOUN
akónkin	akónkin	ADV
akóntema	akóntema	NOUN
ampo	ampo	NOUN
amáca	amáca	NOUN
amáka	amáka	NOUN
amén	amén	NOUN
aménhuaca	aménhuaca	NOUN
améntamo	améntamo	NOUN
aménwaka	aménwaka	NOUN
amí	amí	NOUN
amíco	amíco	NOUN
amíkeska	amíkeska	ADJ
amíko	amíko	NOUN
amíquesca	amíquesca	ADJ
amírica 	amírica 	NOUN
amírika	amírika	NOUN
ana	ana	NOUN
antónyo	antónyo	NOUN
aná	aná	NOUN
anítama	anítama	ADJ
ao	ao	NOUN
apón ániyacati	apón ániyacati	NOUN
apón ániyakati	apón ániyakati	NOUN
aque	aque	ADV
aquéni	aquéni	NOUN
aquínti	aquínti	VERB[T]
ara	ara	NOUN
arabirito	arabirito	NOUN
aresti	aresti	VERB[T]
ari	ari	NOUN
arimania	arimania	NOUN
arimania 	arimania 	NOUN
arábi	arábi	NOUN
arábibaon	arábibaon	ADJ
arámpiri	arámpiri	NOUN
arámpiri 	arámpiri 	NOUN
aráxti	aráxti	VERB[T]
aríari	aríari	NOUN
arína	arína	NOUN
arís	arís	NOUN
arón	arón	NOUN
arós	arós	NOUN
asbpánti	asbpánti	VERB[I]
ashtáati	ashtáati	VERB[T]
ashá	ashá	NOUN
ashón	ashón	ADV
asi	asi	NOUN
asia	asia	NOUN
astó	astó	ADJ
astóati	astóati	VERB[T]
astóti	astóti	VERB[I]
asápa	asápa	NOUN
asíiti	asíiti	NOUN
asíiti 	asíiti 	NOUN
asócaro	asócaro	NOUN
asójiri	asójiri	NOUN
asójiri 	asójiri 	NOUN
asókaro	asókaro	NOUN
atsántita	atsántita	NOUN
atón	atón	NOUN
awá	awá	NOUN
awábero	awábero	NOUN
awájora	awájora	NOUN
awántso	awántso	NOUN
awápa	awápa	NOUN
awápishi	awápishi	NOUN
awátepon	awátepon	NOUN
awín	awín	NOUN
awínhati	awínhati	VERB[T]
axbíti	axbíti	VERB[T]
axánti	axánti	VERB[T]
axé	axé	NOUN
ayáx	ayáx	NOUN
aéiti	aéiti	VERB[I]
aínbo	aínbo	NOUN
aínboapo	aínboapo	NOUN
aínhnetsa	aínhnetsa	NOUN
aínhnetsa 	aínhnetsa 	NOUN
aó	aó	NOUN
ba	ba	NOUN
babán ehua	babán ehua	NOUN
babán ewa	babán ewa	NOUN
bachínti	bachínti	VERB[T]
bacóshti	bacóshti	VERB[I]
bacóx	bacóx	NOUN
bacóxati	bacóxati	VERB[T]
bacóxti	bacóxti	VERB[I]
bahuán ehua	bahuán ehua	NOUN
bahuín	bahuín	NOUN
bai	bai	ADV
bakénki	bakénki	NOUN
bakénti	bakénti	VERB[T]
bakénxa	bakénxa	NOUN
bakéxti	bakéxti	VERB[T]
bakísh	bakísh	ADV
bakóshti	bakóshti	VERB[I]
bakóx	bakóx	NOUN
bakóxati	bakóxati	VERB[T]
bakóxti	bakóxti	VERB[I]
bampís	bampís	NOUN
banjírico	banjírico	ADJ
banjírico	banjírico	NOUN
banjíriko	banjíriko	ADJ
banjíriko	banjíriko	NOUN
banjírio	banjírio	NOUN
bantíja	bantíja	NOUN
bantíra	bantíra	NOUN
bantíra 	bantíra 	NOUN
banxóxti	banxóxti	VERB[T]
baná	baná	ADJ
baná	baná	NOUN
banáshoco	banáshoco	NOUN
banáshoko	banáshoko	NOUN
banénti	banénti	VERB[I]
banéti	banéti	VERB[I]
baquénqui	baquénqui	NOUN
baquénti	baquénti	VERB[T]
baquénxa	baquénxa	NOUN
baquéxti	baquéxti	VERB[T]
baquísh	baquísh	ADV
baránsa	baránsa	NOUN
baránsa 	baránsa 	NOUN
barímpoikeska	barímpoikeska	ADJ
barímpoiquesca	barímpoiquesca	ADJ
barímpol	barímpol	NOUN
barínhameeti	barínhameeti	VERB[I]
barínhati	barínhati	VERB[T]
basháati	basháati	NOUN
basháati 	basháati 	NOUN
bashéxti	bashéxti	VERB[I]
bashósh	bashósh	NOUN
batayón	batayón	NOUN
batánti	batánti	VERB[T]
batón	batón	NOUN
bawán ewa	bawán ewa	NOUN
bawín	bawín	NOUN
baxcá	baxcá	NOUN
baxká	baxká	NOUN
baxáxti	baxáxti	VERB[T]
baxéx	baxéx	NOUN
baxéxati	baxéxati	VERB[T]
baí	baí	NOUN
baíti	baíti	VERB[I]
bebánti	bebánti	VERB[T]
bebí	bebí	ADV
bebón	bebón	ADV
bebón	bebón	POSTP
bebónbires	bebónbires	ADV
bebónbires 	bebónbires 	ADV
bebónhati	bebónhati	VERB[T]
bebónti	bebónti	VERB[I]
bechón	bechón	NOUN
bechónhati	bechónhati	VERB[T]
bechónti	bechónti	VERB[I]
bechóti	bechóti	VERB[T]
becon	becon	ADV
becánti	becánti	VERB[T]
becó	becó	NOUN
becón	becón	ADJ
becónhati	becónhati	VERB[T]
becónti	becónti	VERB[I]
becósh	becósh	ADJ
becósh	becósh	NOUN
behuá	behuá	NOUN
behuéati	behuéati	VERB[T]
behuéti	behuéti	VERB[I]
bekeiba	bekeiba	POSTP
bekon	bekon	ADV
bekánti	bekánti	VERB[T]
bekó	bekó	NOUN
bekón	bekón	ADJ
bekónhati	bekónhati	VERB[T]
bekónti	bekónti	VERB[I]
bekósh	bekósh	ADJ
bekósh	bekósh	NOUN
beméxti	beméxti	VERB[T]
benkéx	benkéx	ADV
benkéx	benkéx	NOUN
benquéx	benquéx	ADV
benquéx	benquéx	NOUN
benxán	benxán	NOUN
benxánti	benxánti	VERB[T]
bená	bená	ADJ
bená mai	bená mai	NOUN
benáati	benáati	VERB[T]
benáti	benáti	ADV
benáti	benáti	VERB[I]
benénpapa	benénpapa	NOUN
benénpia	benénpia	NOUN
benéntita	benéntita	NOUN
benésti	benésti	VERB[I]
benóti	benóti	VERB[I]
bepón	bepón	NOUN
bepónti	bepónti	VERB[I]
bepóti	bepóti	VERB[I]
bequeiba	bequeiba	POSTP
berón iti	berón iti	VERB[I]
bescón	bescón	NOUN
besenen	besenen	POSTP
beshé	beshé	ADJ
beshé	beshé	NOUN
beshéati	beshéati	VERB[T]
beshéti	beshéti	VERB[I]
beskíti	beskíti	VERB[I]
beskón	beskón	NOUN
besquíti	besquíti	VERB[I]
bestéti	bestéti	NOUN
bestéti	bestéti	VERB[I]
besés	besés	ADJ
betan	betan	POSTP
betséti	betséti	VERB[I]
betséti	betséti	VERB[T]
betsínti	betsínti	VERB[I]
betsísti	betsísti	VERB[I]
betsóati	betsóati	VERB[T]
betánti	betánti	VERB[T]
betén	betén	NOUN
beténti	beténti	VERB[T]
betíti	betíti	VERB[I]
betónco	betónco	NOUN
betónko	betónko	NOUN
betóshti	betóshti	VERB[T]
bewá	bewá	NOUN
bewéati	bewéati	VERB[T]
bewéti	bewéti	VERB[I]
bexnán	bexnán	ADJ
bexnán	bexnán	NOUN
bexníti	bexníti	VERB[I]
bextéti	bextéti	VERB[I]
bexéti	bexéti	VERB[T]
beyá	beyá	ADJ
beyáati	beyáati	VERB[I]
beyáti	beyáti	VERB[I]
beyós	beyós	NOUN
beyósati	beyósati	VERB[T]
beyósh	beyósh	ADJ
beyósti	beyósti	VERB[I]
beáxti	beáxti	VERB[T]
beí	beí	NOUN
beísti	beísti	VERB[T]
beón	beón	NOUN
beónti	beónti	VERB[I]
beóti	beóti	VERB[I]
bi	bi	ADV
bibánti	bibánti	VERB[T]
bicho	bicho	ADV
bichínti	bichínti	VERB[T]
bicónya	bicónya	NOUN
bikónya	bikónya	NOUN
bimpísh	bimpísh	NOUN
bimínkeyo	bimínkeyo	NOUN
bimínqueyo	bimínqueyo	NOUN
bincón	bincón	ADJ
binkón	binkón	ADJ
binshín	binshín	ADJ
binsínti	binsínti	VERB[T]
bintána	bintána	NOUN
binákiri	binákiri	NOUN
bináquiri 	bináquiri 	NOUN
binón	binón	NOUN
binóntaxo	binóntaxo	NOUN
bira	bira	ADV
bishcó	bishcó	NOUN
bishcónti	bishcónti	VERB[T]
bishcóti	bishcóti	VERB[I]
bishkó	bishkó	NOUN
bishkónti	bishkónti	VERB[T]
bishkóti	bishkóti	VERB[I]
bishnóati	bishnóati	VERB[T]
bishnóti	bishnóti	VERB[I]
bishtón	bishtón	ADJ
bishtón	bishtón	NOUN
bismánhati	bismánhati	VERB[T]
bismánti	bismánti	VERB[I]
bitáxti	bitáxti	VERB[T]
bix	bix	PRON
bobésti	bobésti	VERB[T]
bobón	bobón	NOUN
bobón 	bobón 	NOUN
bobónhati	bobónhati	VERB[T]
bobónti	bobónti	VERB[T]
bobónti 	bobónti 	VERB[T]
bocháxti	bocháxti	VERB[T]
bocón	bocón	NOUN
bokéti	bokéti	VERB[T]
bokéxti	bokéxti	VERB[T]
bokón	bokón	NOUN
bománti	bománti	VERB[T]
bománya	bománya	NOUN
bonbíti	bonbíti	VERB[I]
bonchón	bonchón	ADJ
boncá	boncá	NOUN
bonká	bonká	NOUN
bonkéati	bonkéati	VERB[T]
bonkébonkeiti	bonkébonkeiti	VERB[I]
bonkéti	bonkéti	VERB[T]
bonquéati	bonquéati	VERB[T]
bonquébonqueiti	bonquébonqueiti	VERB[I]
bonquéti	bonquéti	VERB[T]
bonshísh	bonshísh	NOUN
bonsin	bonsin	NOUN
bonxán	bonxán	NOUN
bonánchai	bonánchai	NOUN
bonánti	bonánti	NOUN
bonéxti	bonéxti	VERB[T]
boquéti	boquéti	VERB[T]
boquéxti	boquéxti	VERB[T]
boró	boró	NOUN
borón	borón	NOUN
borónsi	borónsi	NOUN
borónsi 	borónsi 	NOUN
boróshti	boróshti	VERB[I]
boshicá	boshicá	NOUN
boshiká	boshiká	NOUN
boshí	boshí	NOUN
botonís	botonís	NOUN
botonís 	botonís 	NOUN
botésti	botésti	VERB[T]
botíca	botíca	NOUN
botíka	botíka	NOUN
botíria	botíria	NOUN
botón	botón	NOUN
boxóxti	boxóxti	VERB[I]
boánhis	boánhis	NOUN
boánti	boánti	VERB[I]
boéxeketi	boéxeketi	VERB[I]
boéxequeti	boéxequeti	VERB[I]
boéxeti	boéxeti	NOUN
boéxti	boéxti	VERB[T]
boín	boín	NOUN
boósh	boósh	ADJ
bába	bába	NOUN
bába pímati	bába pímati	NOUN
bába pímati 	bába pímati 	NOUN
báca	báca	ADJ
bácaati	bácaati	VERB[T]
bácati	bácati	VERB[I]
báchi	báchi	NOUN
báchi áti	báchi áti	VERB[T]
báchimeeti	báchimeeti	VERB[I]
báhua	báhua	NOUN
báhuanixo	báhuanixo	NOUN
báhuareshin	báhuareshin	NOUN
báhuatae	báhuatae	NOUN
báiti	báiti	VERB[T]
báka	báka	ADJ
bákaati	bákaati	VERB[T]
bákati	bákati	VERB[I]
báke	báke	NOUN
bákeai jawéki	bákeai jawéki	NOUN
bákeati	bákeati	VERB[T]
bákebenbo	bákebenbo	NOUN
bákeoma	bákeoma	ADJ
bákeonan	bákeonan	NOUN
bákeranon	bákeranon	NOUN
bákeshoko	bákeshoko	NOUN
báketian	báketian	ADV
bámati	bámati	VERB[I]
bánacaati	bánacaati	VERB[I]
bánakaati	bánakaati	VERB[I]
bánati	bánati	VERB[T]
bánca	bánca	NOUN
bánco	bánco	NOUN
báneti	báneti	VERB[T]
bánjirista	bánjirista	NOUN
bánka	bánka	NOUN
bánko	bánko	NOUN
bánoti	bánoti	VERB[T]
bánta	bánta	NOUN
báo	báo	NOUN
báo 	báo 	NOUN
báotismo	báotismo	NOUN
bápi	bápi	NOUN
báque	báque	NOUN
báqueai jahuéqui 	báqueai jahuéqui 	NOUN
báqueati	báqueati	VERB[T]
báquebenbo	báquebenbo	NOUN
báqueoma	báqueoma	ADJ
báqueonan	báqueonan	NOUN
báqueranon	báqueranon	NOUN
báqueshoco	báqueshoco	NOUN
báquetian	báquetian	ADV
bári	bári	NOUN
báritia	báritia	NOUN
báritian	báritian	ADV
báritiati	báritiati	VERB[I]
bási	bási	ADV
bási iti	bási iti	VERB[I]
básibo	básibo	ADV
básiti	básiti	VERB[I]
báso	báso	NOUN
báta	báta	ADJ
bátaro	bátaro	NOUN
bátati	bátati	VERB[I]
bátiria	bátiria	NOUN
bátiria 	bátiria 	NOUN
bátiria jéne	bátiria jéne	NOUN
bátiria jéne 	bátiria jéne 	NOUN
báwa	báwa	NOUN
báwanixo	báwanixo	NOUN
báwareshin	báwareshin	NOUN
báwatae	báwatae	NOUN
báxo	báxo	NOUN
bébati	bébati	VERB[I]
béchexeeti	béchexeeti	VERB[I]
béchi	béchi	ADJ
béchiteti	béchiteti	VERB[T]
béchiti	béchiti	VERB[I]
béchiti	béchiti	VERB[T]
béchokiiti	béchokiiti	VERB[I]
béchoquiiti	béchoquiiti	VERB[I]
béchoti	béchoti	VERB[T]
béhuati	béhuati	VERB[I]
béhueti	béhueti	VERB[T]
békepiti	békepiti	VERB[I]
béma	béma	NOUN
bémanan	bémanan	NOUN
bémati	bémati	VERB[T]
bénacahue	bénacahue	NOUN
bénakawe	bénakawe	NOUN
bénati	bénati	VERB[T]
bénbo	bénbo	NOUN
bénbo 	bénbo 	NOUN
bénche	bénche	NOUN
béncheati	béncheati	VERB[T]
béncheti	béncheti	VERB[I]
béne	béne	ADJ
béne	béne	NOUN
béneati	béneati	VERB[T]
béneti	béneti	VERB[I]
béno	béno	NOUN
bénomaati	bénomaati	VERB[I]
bénooma	bénooma	NOUN
bénoti	bénoti	VERB[I]
bénoti	bénoti	VERB[T]
bénoya	bénoya	ADJ
bénta	bénta	NOUN
bénxo	bénxo	NOUN
bénxoati	bénxoati	VERB[T]
bénxocaati	bénxocaati	VERB[I]
bénxokaati	bénxokaati	VERB[I]
bénxoti	bénxoti	VERB[I]
béotiti	béotiti	VERB[I]
bépe	bépe	ADJ
bépeti	bépeti	VERB[I]
bépo	bépo	NOUN
bépocooti	bépocooti	VERB[I]
bépokooti	bépokooti	VERB[I]
bépoti	bépoti	VERB[I]
bépoti	bépoti	VERB[T]
béquepiti	béquepiti	VERB[I]
bérani	bérani	NOUN
bérani 	bérani 	NOUN
bériiti	bériiti	VERB[I]
béro	béro	NOUN
bérocapoxco	bérocapoxco	NOUN
bérocarani	bérocarani	NOUN
bérochipon	bérochipon	NOUN
bérochon	bérochon	NOUN
béroisin	béroisin	NOUN
bérokapoxko	bérokapoxko	NOUN
bérokarani	bérokarani	NOUN
bérokexni	bérokexni	NOUN
béronami	béronami	NOUN
béroquexni	béroquexni	NOUN
bérorao	bérorao	NOUN
bérotapoco	bérotapoco	NOUN
bérotapoko	bérotapoko	NOUN
bérotapon	bérotapon	NOUN
béroxanto	béroxanto	NOUN
béroyoshin	béroyoshin	NOUN
bésbe	bésbe	NOUN
béshpi	béshpi	NOUN
bésipon	bésipon	NOUN
béskiti	béskiti	VERB[T]
bésmi	bésmi	ADJ
bésmiti	bésmiti	VERB[I]
bésoikiiti	bésoikiiti	NOUN
bésoikiiti	bésoikiiti	VERB[T]
bésoiquiiti	bésoiquiiti	NOUN
bésoiquiiti	bésoiquiiti	VERB[T]
bésoti	bésoti	VERB[I]
bésoti	bésoti	VERB[T]
bésquiti	bésquiti	VERB[T]
bésteti	bésteti	VERB[T]
bétaneti	bétaneti	NOUN
bétaneti	bétaneti	VERB[T]
bétaro	bétaro	NOUN
bétashiti	bétashiti	VERB[I]
béti	béti	VERB[T]
bétoken ewa	bétoken ewa	NOUN
bétoquen ehua 	bétoquen ehua 	NOUN
bétoshbaati	bétoshbaati	VERB[T]
bétsati	bétsati	VERB[T]
bétsekeeti	bétsekeeti	VERB[I]
bétsequeeti	bétsequeeti	VERB[I]
bétsoti	bétsoti	VERB[I]
béwati	béwati	VERB[I]
béweti	béweti	VERB[T]
béxa	béxa	ADJ
béxati	béxati	VERB[I]
béxca	béxca	ADJ
béxca	béxca	NOUN
béxco	béxco	NOUN
béxka	béxka	ADJ
béxka	béxka	NOUN
béxko	béxko	NOUN
béxmi	béxmi	ADJ
béxmiati	béxmiati	VERB[T]
béxmiti	béxmiti	VERB[I]
béxpe	béxpe	ADJ
béxpetonco	béxpetonco	NOUN
béxpetonko	béxpetonko	NOUN
béyoshinti	béyoshinti	VERB[I]
bíacaati	bíacaati	VERB[I]
bíakaati	bíakaati	VERB[I]
bícha	bícha	ADJ
bícha	bícha	NOUN
bíchati	bíchati	VERB[I]
bíchi	bíchi	NOUN
bíchimeeti	bíchimeeti	VERB[I]
bídirio	bídirio	NOUN
bíhui	bíhui	NOUN
bíi	bíi	NOUN
bíin	bíin	ADJ
bíinhati	bíinhati	VERB[T]
bími	bími	NOUN
bímiti	bímiti	VERB[I]
bímpachi	bímpachi	NOUN
bína	bína	NOUN
bínirisinti	bínirisinti	VERB[T]
bínirisinti 	bínirisinti 	VERB[T]
bíno	bíno	NOUN
bínti	bínti	NOUN
bínti 	bínti 	NOUN
bíntiocho	bíntiocho	NOUN
bíri	bíri	NOUN
bíriaabe	bíriaabe	NOUN
bíriati	bíriati	VERB[T]
bíribina	bíribina	NOUN
bírimeni	bírimeni	NOUN
bíriti	bíriti	VERB[I]
bíshcoti	bíshcoti	VERB[T]
bíshkoti	bíshkoti	VERB[T]
bísi	bísi	ADJ
bísikirita	bísikirita	NOUN
bísiquirita	bísiquirita	NOUN
bískiati	bískiati	NOUN
bískiati	bískiati	VERB[T]
bískiiti	bískiiti	VERB[I]
bísquiati	bísquiati	NOUN
bísquiati	bísquiati	VERB[T]
bísquiiti	bísquiiti	VERB[I]
bíta	bíta	NOUN
bítaxameeti	bítaxameeti	VERB[I]
bíti	bíti	VERB[T]
bíwi	bíwi	NOUN
bóca	bóca	NOUN
bóchiki	bóchiki	ADV
bóchiki	bóchiki	POSTP
bóchiqui	bóchiqui	ADV
bóchiqui	bóchiqui	POSTP
bócho	bócho	ADJ
bóco	bóco	NOUN
bóe	bóe	NOUN
bóeati	bóeati	NOUN
bói	bói	NOUN
bójaro	bójaro	NOUN
bójaro 	bójaro 	NOUN
bóka	bóka	NOUN
bóki	bóki	NOUN
bóko	bóko	NOUN
bómati	bómati	NOUN
bómati	bómati	VERB[T]
bóme	bóme	NOUN
bómpa	bómpa	NOUN
bómpo	bómpo	NOUN
bóna	bóna	NOUN
bónajene	bónajene	NOUN
bónamishkin	bónamishkin	NOUN
bónamishquin	bónamishquin	NOUN
bónaya	bónaya	ADJ
bónchibo	bónchibo	NOUN
bónco	bónco	NOUN
bóncoati	bóncoati	VERB[T]
bóncoti	bóncoti	VERB[I]
bónexeeti	bónexeeti	VERB[I]
bónko	bónko	NOUN
bónkoati	bónkoati	VERB[T]
bónkoti	bónkoti	VERB[I]
bóntoish	bóntoish	NOUN
bóo	bóo	NOUN
bóoti	bóoti	VERB[I]
bóqui	bóqui	NOUN
bóro	bóro	NOUN
bórosa	bórosa	NOUN
bósa	bósa	NOUN
bóshti	bóshti	ADJ
bóshti	bóshti	NOUN
bóshtiati	bóshtiati	VERB[T]
bóshtiti	bóshtiti	VERB[I]
bóteti	bóteti	VERB[T]
bóti	bóti	VERB[T]
bóxteti	bóxteti	VERB[T]
bóya	bóya	NOUN
bóyacaati	bóyacaati	VERB[I]
bóyakaati	bóyakaati	VERB[I]
bóyati	bóyati	VERB[T]
ca	ca	NOUN
ca 	ca 	ADV
cabáyo	cabáyo	NOUN
cabésti	cabésti	VERB[T]
cabéx	cabéx	ADJ
cabínhati	cabínhati	VERB[T]
cabínti	cabínti	VERB[I]
cabóri	cabóri	NOUN
cabórinimpiti	cabórinimpiti	NOUN
cachán	cachán	NOUN
cacháxti	cacháxti	VERB[T]
cacán	cacán	NOUN
cahuá	cahuá	NOUN
cahuánti 	cahuánti 	VERB[I]
cahuáti	cahuáti	NOUN
cahuáti	cahuáti	VERB[T]
cahué ati	cahué ati	VERB[T]
cahuín	cahuín	NOUN
cahuís	cahuís	ADJ
cahuíshpo	cahuíshpo	NOUN
cain	cain	ADV
cají	cají	NOUN
cajónshoco	cajónshoco	NOUN
caman	caman	POSTP
campánya	campánya	NOUN
camán	camán	NOUN
camári	camári	NOUN
camés	camés	ADJ
caméxti	caméxti	VERB[T]
camícho 	camícho 	NOUN
camís	camís	NOUN
camíti	camíti	VERB[I]
camósti	camósti	VERB[T]
camóx	camóx	NOUN
can	can	ADV
canará 	canará 	NOUN
canchán	canchán	NOUN
canchónhati	canchónhati	VERB[T]
cancámporo	cancámporo	NOUN
cancán	cancán	NOUN
cancóro 	cancóro 	NOUN
canshín	canshín	ADJ
canshínti	canshínti	VERB[I]
cantsín	cantsín	NOUN
cantína	cantína	NOUN
caná	caná	NOUN
canán ehua	canán ehua	NOUN
canántancho	canántancho	NOUN
canánti	canánti	VERB[T]
canás	canás	NOUN
canéna	canéna	NOUN
canéxti	canéxti	VERB[T]
canóti	canóti	NOUN
capábo	capábo	NOUN
capé	capé	NOUN
capé coi	capé coi	NOUN
capéshin	capéshin	NOUN
capéti	capéti	VERB[I]
capéti	capéti	VERB[T]
capín	capín	NOUN
capónhati	capónhati	VERB[T]
capóti	capóti	VERB[I]
capóti	capóti	VERB[T]
caquín	caquín	NOUN
caribó	caribó	NOUN
carájon	carájon	NOUN
caránbeti	caránbeti	VERB[T]
caréco	caréco	NOUN
carínan	carínan	NOUN
caríti	caríti	NOUN
caró	caró	NOUN
carónchempan 	carónchempan 	NOUN
carós	carós	NOUN
cas	cas	ADV
cashímpo	cashímpo	NOUN
cashóati	cashóati	VERB[T]
castícameeti	castícameeti	VERB[I]
castícanti	castícanti	VERB[T]
castíco	castíco	NOUN
castóro 	castóro 	NOUN
casórina	casórina	NOUN
cato	cato	ADV
catsáti	catsáti	VERB[I]
catsáti	catsáti	VERB[T]
catséti	catséti	VERB[T]
catásho	catásho	NOUN
catáxti	catáxti	VERB[T]
catéti	catéti	VERB[T]
catórico 	catórico 	ADJ
catóti	catóti	VERB[T]
catóxco	catóxco	NOUN
caxbá	caxbá	NOUN
caxquéti	caxquéti	VERB[I]
caxquíti	caxquíti	VERB[I]
caxtéti	caxtéti	VERB[I]
caya	caya	ADV
cayánari	cayánari	NOUN
cayária	cayária	NOUN
caéxcaesh	caéxcaesh	NOUN
caéxiti	caéxiti	VERB[I]
caíai	caíai	ADJ
caíati	caíati	VERB[T]
caíbo	caíbo	NOUN
caímito	caímito	NOUN
caín	caín	NOUN
caíns	caíns	NOUN
caís	caís	NOUN
caíti	caíti	VERB[I]
cha	cha	ADV
cha	cha	NOUN
cha 	cha 	ADV
chacháati	chacháati	VERB[I]
chacháti	chacháti	VERB[I]
chachí	chachí	NOUN
chachíti	chachíti	VERB[I]
chacá	chacá	ADJ
chacá	chacá	NOUN
chacásh ati	chacásh ati	VERB[T]
chacásh iti	chacásh iti	VERB[I]
chacáti	chacáti	VERB[I]
chacóiti	chacóiti	VERB[I]
chahuá	chahuá	NOUN
chahuáti	chahuáti	VERB[I]
chaká	chaká	ADJ
chaká	chaká	NOUN
chakásh ati	chakásh ati	VERB[T]
chakásh iti	chakásh iti	VERB[I]
chakáti	chakáti	VERB[I]
chakóiti	chakóiti	VERB[I]
chamá	chamá	NOUN
chancánti	chancánti	VERB[T]
chancáti	chancáti	VERB[T]
chankánti	chankánti	VERB[T]
chankáti	chankáti	VERB[T]
chankéti	chankéti	VERB[I]
chanquéti	chanquéti	VERB[I]
chantómari	chantómari	NOUN
chaníti	chaníti	VERB[I]
chapáati	chapáati	VERB[T]
chapáti	chapáti	VERB[I]
charáati	charáati	VERB[T]
charánhua	charánhua	NOUN
charánwa	charánwa	NOUN
charáti	charáti	VERB[I]
charáx	charáx	NOUN
charísh	charísh	ADJ
charíshati	charíshati	VERB[T]
charíshti	charíshti	VERB[I]
charónti	charónti	VERB[T]
charóti	charóti	VERB[I]
chashí	chashí	NOUN
chashíti	chashíti	VERB[I]
chawá	chawá	NOUN
chawáti	chawáti	VERB[I]
chaxóx	chaxóx	NOUN
chaíshati	chaíshati	VERB[T]
chaíshiti	chaíshiti	VERB[I]
chepán ehua	chepán ehua	NOUN
chepán ewa	chepán ewa	NOUN
cheréti	cheréti	VERB[I]
chexá	chexá	NOUN
cheáti	cheáti	VERB[I]
cheí	cheí	NOUN
cheó	cheó	NOUN
cheón iti	cheón iti	VERB[I]
cheón iti 	cheón iti 	VERB[I]
chibá	chibá	NOUN
chibánti	chibánti	VERB[T]
chibíti	chibíti	VERB[T]
chibó	chibó	NOUN
chibón	chibón	NOUN
chicho	chicho	ADJ
chichínhuitax	chichínhuitax	NOUN
chichínti	chichínti	VERB[T]
chichínwitax	chichínwitax	NOUN
chichíporo	chichíporo	NOUN
chichó	chichó	ADV
chichó	chichó	NOUN
chichó	chichó	POSTP
chichóati	chichóati	VERB[T]
chichóti	chichóti	VERB[I]
chichóti	chichóti	VERB[T]
chicáro	chicáro	NOUN
chicóro	chicóro	NOUN
chicósh	chicósh	ADJ
chicóshquinti	chicóshquinti	NOUN
chicóti	chicóti	VERB[I]
chihuáti	chihuáti	VERB[T]
chihuéti	chihuéti	VERB[T]
chihuínti	chihuínti	NOUN
chihuínti	chihuínti	VERB[T]
chikáro	chikáro	NOUN
chiké	chiké	NOUN
chikénti	chikénti	VERB[T]
chikéxti	chikéxti	VERB[T]
chikísh	chikísh	ADJ
chikíshti	chikíshti	VERB[I]
chikóro	chikóro	NOUN
chikósh	chikósh	ADJ
chikóshkinti	chikóshkinti	NOUN
chikóti	chikóti	VERB[I]
chimpansí	chimpansí	NOUN
chimpansí 	chimpansí 	NOUN
chimánti	chimánti	VERB[T]
chimápo	chimápo	NOUN
chimín	chimín	NOUN
chincán	chincán	NOUN
chinkán	chinkán	NOUN
chinshín	chinshín	ADJ
chinéxti	chinéxti	VERB[T]
chiní	chiní	ADJ
chiní	chiní	NOUN
chiníti	chiníti	VERB[I]
chinó	chinó	ADJ
chio	chio	NOUN
chipán	chipán	NOUN
chipéti	chipéti	VERB[T]
chipéxco	chipéxco	NOUN
chipéxko	chipéxko	NOUN
chipíshti	chipíshti	VERB[T]
chipónki	chipónki	ADV
chipónqui	chipónqui	ADV
chipóti	chipóti	VERB[I]
chiqué	chiqué	NOUN
chiquénti	chiquénti	VERB[T]
chiquéxti	chiquéxti	VERB[T]
chiquísh	chiquísh	ADJ
chiquíshti	chiquíshti	VERB[I]
chiráncooti	chiráncooti	VERB[I]
chiránkooti	chiránkooti	VERB[I]
chirápa	chirápa	NOUN
chirínti	chirínti	VERB[T]
chishbíti	chishbíti	VERB[I]
chisés	chisés	ADJ
chitáxti	chitáxti	VERB[T]
chité	chité	NOUN
chitéti	chitéti	VERB[T]
chitéxti	chitéxti	VERB[T]
chitíati	chitíati	VERB[T]
chitínti	chitínti	VERB[T]
chitíti	chitíti	VERB[T]
chitóati	chitóati	VERB[T]
chitónti	chitónti	NOUN
chitónti	chitónti	VERB[T]
chitóti	chitóti	VERB[I]
chiwáti	chiwáti	VERB[T]
chiwéti	chiwéti	VERB[T]
chiwínti	chiwínti	NOUN
chiwínti	chiwínti	VERB[T]
chixkíti	chixkíti	VERB[I]
chixpó	chixpó	NOUN
chixquíti	chixquíti	VERB[I]
chixá	chixá	ADJ
chixána	chixána	NOUN
chixén	chixén	NOUN
chixó	chixó	NOUN
chixóti	chixóti	VERB[I]
chixóxti	chixóxti	VERB[I]
chiáraxti	chiáraxti	NOUN
chiáraxti 	chiáraxti 	NOUN
chiáti	chiáti	VERB[I]
chiáxca	chiáxca	ADJ
chiáxka	chiáxka	ADJ
chiósh	chiósh	ADJ
chióx	chióx	ADJ
cho	cho	NOUN
choké	choké	NOUN
chokíti	chokíti	VERB[I]
chonkéx	chonkéx	NOUN
chonquéx	chonquéx	NOUN
chonónininti	chonónininti	NOUN
chopé	chopé	NOUN
chopéti	chopéti	VERB[I]
chopíti	chopíti	NOUN
choqué	choqué	NOUN
choquíti	choquíti	VERB[I]
choránti	choránti	VERB[I]
choré	choré	NOUN
chorísh	chorísh	ADJ
choríshati	choríshati	VERB[T]
choríshti	choríshti	VERB[I]
chorónti	chorónti	VERB[I]
choróti	choróti	VERB[I]
choshcáti	choshcáti	VERB[I]
choshkáti	choshkáti	VERB[I]
choshíti	choshíti	VERB[I]
chotáti	chotáti	NOUN
chotáyosma aínbo	chotáyosma aínbo	NOUN
choín	choín	NOUN
cháa	cháa	NOUN
chábi	chábi	NOUN
chábi 	chábi 	NOUN
chácati	chácati	VERB[T]
cháchimis	cháchimis	NOUN
cháchiti	cháchiti	NOUN
cháchiti	cháchiti	VERB[T]
cháhua	cháhua	NOUN
chái	chái	NOUN
cháiconi	cháiconi	NOUN
cháikoni	cháikoni	NOUN
chákati	chákati	VERB[T]
cháki	cháki	NOUN
chákipata	chákipata	NOUN
chámi	chámi	NOUN
chámpi	chámpi	NOUN
chámpo	chámpo	NOUN
chána	chána	NOUN
chánca	chánca	ADJ
chánco	chánco	NOUN
cháncoti	cháncoti	VERB[I]
cháncoxahue	cháncoxahue	NOUN
chániti	chániti	VERB[T]
chánka	chánka	ADJ
chánko	chánko	NOUN
chánkoti	chánkoti	VERB[I]
chánkoxawe	chánkoxawe	NOUN
chánta	chánta	NOUN
chánti	chánti	NOUN
chánto	chánto	NOUN
chántoati	chántoati	VERB[T]
chántoti	chántoti	VERB[I]
cháopi	cháopi	NOUN
chápata	chápata	NOUN
cháqui	cháqui	NOUN
cháquipata	cháquipata	NOUN
cháraiti	cháraiti	VERB[I]
chárati	chárati	VERB[T]
chári	chári	NOUN
cháro	cháro	NOUN
cháti	cháti	NOUN
cháwa	cháwa	NOUN
cháxati	cháxati	VERB[T]
cháxo	cháxo	NOUN
cháxo lnón chibáni	cháxo lnón chibáni	NOUN
cháxobichi	cháxobichi	NOUN
chéati	chéati	VERB[T]
chéco	chéco	ADJ
chécoati	chécoati	VERB[T]
chécoti	chécoti	VERB[I]
chékerenti	chékerenti	VERB[T]
chéko	chéko	ADJ
chékoati	chékoati	VERB[T]
chékoti	chékoti	VERB[I]
chépa	chépa	NOUN
chéquerenti	chéquerenti	VERB[T]
chéxati	chéxati	VERB[T]
chéxe	chéxe	ADJ
chéxeati	chéxeati	VERB[T]
chéxeti	chéxeti	VERB[I]
chíacati	chíacati	VERB[T]
chíakati	chíakati	VERB[T]
chíati	chíati	NOUN
chíbero	chíbero	NOUN
chíbo	chíbo	NOUN
chíchi	chíchi	NOUN
chíchica	chíchica	NOUN
chíchika	chíchika	NOUN
chíchiti	chíchiti	VERB[I]
chíchokiiti	chíchokiiti	VERB[I]
chíchoquiiti	chíchoquiiti	VERB[I]
chícoti	chícoti	VERB[T]
chíhueti	chíhueti	VERB[T]
chíhuimeeti	chíhuimeeti	VERB[I]
chíi	chíi	NOUN
chíican ehua	chíican ehua	NOUN
chíijexco	chíijexco	NOUN
chíijexko	chíijexko	NOUN
chíikan ewa	chíikan ewa	NOUN
chíimacan	chíimacan	NOUN
chíimakan	chíimakan	NOUN
chíimapo	chíimapo	NOUN
chíki	chíki	NOUN
chíkiraya	chíkiraya	NOUN
chíkitaro	chíkitaro	NOUN
chíkoti	chíkoti	VERB[T]
chímacayan	chímacayan	NOUN
chímakayan	chímakayan	NOUN
chímpa	chímpa	NOUN
chínexeeti	chínexeeti	VERB[I]
chínexeti	chínexeti	NOUN
chínexeti 	chínexeti 	NOUN
chínoti	chínoti	NOUN
chínoti	chínoti	VERB[T]
chínti	chínti	NOUN
chínto	chínto	ADJ
chínto	chínto	NOUN
chíobake	chíobake	NOUN
chíobaque 	chíobaque 	NOUN
chípeke	chípeke	NOUN
chípekeeti	chípekeeti	VERB[I]
chípeque	chípeque	NOUN
chípequeeti	chípequeeti	VERB[I]
chípi	chípi	NOUN
chípia	chípia	NOUN
chípishiiti	chípishiiti	VERB[I]
chípiyoxan	chípiyoxan	NOUN
chípiyoxan 	chípiyoxan 	NOUN
chíqui 	chíqui 	NOUN
chíquiraya	chíquiraya	NOUN
chíquitaro	chíquitaro	NOUN
chírehuin	chírehuin	NOUN
chírewin	chírewin	NOUN
chíro	chíro	ADJ
chíroati	chíroati	VERB[T]
chíroti	chíroti	VERB[I]
chíshpi	chíshpi	NOUN
chítaca	chítaca	NOUN
chítaka	chítaka	NOUN
chíte	chíte	ADJ
chíte	chíte	NOUN
chíteati	chíteati	VERB[T]
chíteti	chíteti	VERB[I]
chíteti	chíteti	VERB[T]
chítoti	chítoti	VERB[T]
chíweti	chíweti	VERB[T]
chíwimeeti	chíwimeeti	VERB[I]
chíxca	chíxca	NOUN
chíxco	chíxco	ADJ
chíxka	chíxka	NOUN
chíxko	chíxko	ADJ
chíxni	chíxni	NOUN
chíxo	chíxo	NOUN
chíxteti	chíxteti	VERB[T]
chóa	chóa	NOUN
chócati	chócati	VERB[T]
chóchahuasha 	chóchahuasha 	NOUN
chóchawasha	chóchawasha	NOUN
chókati	chókati	VERB[T]
chóki	chóki	NOUN
chókiati	chókiati	VERB[T]
chóma	chóma	NOUN
chómati	chómati	VERB[I]
chómo	chómo	NOUN
chómoati	chómoati	VERB[I]
chómpa	chómpa	NOUN
chómpe	chómpe	NOUN
chómpi	chómpi	NOUN
chónca	chónca	ADJ
chóncho	chóncho	NOUN
chónka	chónka	ADJ
chóno	chóno	NOUN
chópa	chópa	NOUN
chópai	chópai	NOUN
chópaoma	chópaoma	ADJ
chópeti	chópeti	VERB[T]
chópiananti	chópiananti	NOUN
chóqui	chóqui	NOUN
chóquiati	chóquiati	VERB[T]
chórameeti	chórameeti	VERB[I]
chóre	chóre	NOUN
chórocooti	chórocooti	VERB[I]
chórokooti	chórokooti	VERB[I]
chóroti	chóroti	VERB[T]
chósco	chósco	ADJ
chóscoi	chóscoi	ADV
chóshati	chóshati	VERB[T]
chóshcaati	chóshcaati	VERB[T]
chóshi	chóshi	ADJ
chóshiti	chóshiti	VERB[I]
chóshkaati	chóshkaati	VERB[T]
chósko	chósko	ADJ
chóskoi	chóskoi	ADV
chótati	chótati	VERB[T]
chóyachaki	chóyachaki	NOUN
chóyachaqui	chóyachaqui	NOUN
chóyo	chóyo	NOUN
cobínhati	cobínhati	VERB[T]
cobínti	cobínti	VERB[I]
cobís	cobís	ADJ
cobítaxti	cobítaxti	VERB[T]
cobóati	cobóati	VERB[T]
cobóiti	cobóiti	VERB[I]
cochára	cochára	NOUN
cochón	cochón	ADJ
cochónti	cochónti	VERB[T]
cocoríiti	cocoríiti	VERB[I]
cocáiqui isáni	cocáiqui isáni	NOUN
cocáme	cocáme	NOUN
cocán ahuin	cocán ahuin	NOUN
cocáracha	cocáracha	NOUN
comán	comán	NOUN
comán ehua	comán ehua	NOUN
comári 	comári 	NOUN
comárinia	comárinia	NOUN
comén	comén	NOUN
coméxti	coméxti	VERB[T]
comíco	comíco	NOUN
comón ati	comón ati	VERB[T]
comón iti	comón iti	VERB[I]
con	con	ADV
concón	concón	NOUN
conjíti	conjíti	NOUN
conquísh	conquísh	NOUN
conrón	conrón	NOUN
contá	contá	NOUN
conxán	conxán	NOUN
conésati	conésati	VERB[T]
coníjo 	coníjo 	NOUN
conín ehua	conín ehua	NOUN
conónbi	conónbi	NOUN
copi	copi	POSTP
copén	copén	NOUN
copéti	copéti	VERB[T]
copí	copí	ADJ
copí	copí	NOUN
copíati	copíati	VERB[T]
copíma	copíma	ADJ
copíti 	copíti 	VERB[I]
copítso	copítso	NOUN
corá	corá	ADJ
corá	corá	NOUN
coráati	coráati	VERB[T]
coráca	coráca	NOUN
corário	corário	NOUN
coráti	coráti	VERB[I]
coríchi 	coríchi 	NOUN
coríqui	coríqui	NOUN
coríquinin títa	coríquinin títa	NOUN
coróro 	coróro 	NOUN
corós	corós	NOUN
coshpámparo	coshpámparo	NOUN
coshpán	coshpán	NOUN
coshquínti	coshquínti	VERB[T]
coshquíti	coshquíti	VERB[I]
coshín	coshín	ADV
coshónti	coshónti	VERB[T]
coshóshca	coshóshca	NOUN
cosquéti	cosquéti	VERB[I]
cosés	cosés	ADJ
cotón	cotón	NOUN
coxcóxtobi	coxcóxtobi	NOUN
coxtéti	coxtéti	VERB[I]
coxéti	coxéti	VERB[T]
coxónehua	coxónehua	NOUN
coxónshehua	coxónshehua	NOUN
coyénque	coyénque	NOUN
coyósh	coyósh	ADJ
coánacha	coánacha	NOUN
coáratia	coáratia	NOUN
coásti	coásti	VERB[T]
coáti	coáti	VERB[T]
coéti	coéti	VERB[T]
coín 	coín 	NOUN
coínbires	coínbires	ADJ
coíncoin	coíncoin	NOUN
coínti	coínti	VERB[I]
coíranti	coíranti	VERB[T]
coíshiti	coíshiti	VERB[I]
coíshti	coíshti	VERB[T]
cábirata	cábirata	NOUN
cábo	cábo	NOUN
cácaati	cácaati	VERB[T]
cáchiana	cáchiana	ADJ
cáchianti	cáchianti	VERB[T]
cáchibanti	cáchibanti	VERB[T]
cáchio	cáchio	ADV
cáchoti	cáchoti	VERB[I]
cáhua	cáhua	NOUN
cáhuati	cáhuati	VERB[T]
cái ati	cái ati	VERB[T]
cája	cája	NOUN
cámaronca	cámaronca	NOUN
cámaronti	cámaronti	NOUN
cámpa	cámpa	NOUN
cámpianti	cámpianti	VERB[T]
cámpo	cámpo	NOUN
cána	cána	NOUN
cánachiari	cánachiari	NOUN
cánain	cánain	NOUN
cánaoon 	cánaoon 	NOUN
cánapo	cánapo	NOUN
cáncaati	cáncaati	VERB[T]
cánchis	cánchis	ADJ
cánchoti 	cánchoti 	VERB[I]
cáno	cáno	NOUN
cánsa 	cánsa 	NOUN
cánso 	cánso 	NOUN
cáo	cáo	NOUN
cáocho	cáocho	NOUN
cáochohepon	cáochohepon	NOUN
cápa	cápa	NOUN
cápajobo$bco	cápajobo$bco	NOUN
cápapiti 	cápapiti 	NOUN
cápaqucti	cápaqucti	NOUN
cápeten axa 	cápeten axa 	NOUN
cápitan	cápitan	NOUN
cápocaati	cápocaati	VERB[I]
cáposoro	cáposoro	NOUN
cápoti	cápoti	VERB[T]
cáqui	cáqui	NOUN
cára 	cára 	ADJ
cára.	cára.	NOUN
cáraboso	cáraboso	NOUN
cáraniro 	cáraniro 	NOUN
cáranirobaque 	cáranirobaque 	NOUN
cáranirobichi 	cáranirobichi 	NOUN
cárapintiro 	cárapintiro 	NOUN
cárapita 	cárapita 	NOUN
cárasira	cárasira	NOUN
cárata	cárata	NOUN
cári	cári	NOUN
cáritira	cáritira	NOUN
cáro	cáro	NOUN
cároati	cároati	VERB[T]
cárotae	cárotae	NOUN
cáshcacashca ati	cáshcacashca ati	VERB[T]
cáshi	cáshi	NOUN
cáshibo	cáshibo	NOUN
cásho	cásho	NOUN
cásiosa 	cásiosa 	NOUN
cásoati 	cásoati 	VERB[T]
cásoti	cásoti	VERB[T]
cástichano	cástichano	NOUN
cáta	cáta	NOUN
cátaati	cátaati	VERB[T]
cátati	cátati	VERB[I]
cátaxameeti	cátaxameeti	VERB[I]
cátaxomeeti	cátaxomeeti	VERB[I]
cáte	cáte	NOUN
cáteti	cáteti	VERB[T]
cáti 	cáti 	VERB[I]
cátocaati	cátocaati	VERB[I]
cátoti 	cátoti 	VERB[T]
cáxa	cáxa	ADJ
cáxati	cáxati	VERB[I]
cáxni	cáxni	NOUN
cáxo	cáxo	NOUN
cáxo xao	cáxo xao	NOUN
cáxopa	cáxopa	NOUN
cáxque	cáxque	NOUN
cáxqueti	cáxqueti	VERB[T]
cáxquiti	cáxquiti	VERB[T]
cáxteti	cáxteti	VERB[T]
cáya	cáya	ADJ
cáya	cáya	NOUN
cáyanenque	cáyanenque	NOUN
cáyatsahui	cáyatsahui	NOUN
cáyatseca	cáyatseca	NOUN
cóarino 	cóarino 	NOUN
cóbi 	cóbi 	NOUN
cóboranti	cóboranti	VERB[T]
cóca 	cóca 	NOUN
cóchi	cóchi	NOUN
cóco 	cóco 	NOUN
cócoti	cócoti	VERB[T]
cóe	cóe	ADJ
cóeti	cóeti	VERB[I]
cói	cói	NOUN
cóicoiro	cóicoiro	NOUN
cóitatas	cóitatas	NOUN
cóma	cóma	NOUN
cómatsehue	cómatsehue	NOUN
cómocomo	cómocomo	NOUN
cómpa	cómpa	NOUN
cómpanyiro 	cómpanyiro 	NOUN
cónahue	cónahue	NOUN
cóncho	cóncho	NOUN
cóni	cóni	NOUN
cónibo	cónibo	NOUN
cóno	cóno	NOUN
cónxamanchai	cónxamanchai	NOUN
cóo	cóo	NOUN
cóojison	cóojison	NOUN
cóoti	cóoti	VERB[I]
cópeque	cópeque	NOUN
cópiquin	cópiquin	VERB[PP1]
cópiti	cópiti	VERB[T]
córi	córi	NOUN
córi inca	córi inca	NOUN
córiapiri 	córiapiri 	NOUN
córimachapa	córimachapa	NOUN
córo	córo	ADJ
córo	córo	NOUN
córoati	córoati	VERB[T]
córocha 	córocha 	NOUN
córocoro	córocoro	NOUN
córonita	córonita	NOUN
córopo 	córopo 	NOUN
córoti	córoti	VERB[I]
cóshi	cóshi	ADJ
cóshi	cóshi	NOUN
cóshiati	cóshiati	VERB[T]
cóshiti	cóshiti	VERB[I]
cósho	cósho	NOUN
cóshomeeti	cóshomeeti	VERB[I]
cóshori	cóshori	NOUN
cóshorinin matsóti	cóshorinin matsóti	NOUN
cósi	cósi	NOUN
cósinira	cósinira	NOUN
cósqueti	cósqueti	VERB[T]
cósquiti	cósquiti	VERB[T]
cóta	cóta	NOUN
cóxba	cóxba	ADJ
cóxcochi	cóxcochi	NOUN
cóxcoraniti	cóxcoraniti	VERB[I]
cóxni	cóxni	NOUN
cóxo	cóxo	NOUN
cóxopeox	cóxopeox	NOUN
cóxteti	cóxteti	VERB[T]
cóyaparo	cóyaparo	NOUN
cóyo	cóyo	NOUN
cóyobocho	cóyobocho	NOUN
e	e	NOUN
ea	ea	PRON
ehua	ehua	ADV
esé	esé	NOUN
eséti	eséti	VERB[I]
ewa	ewa	ADV
hua	hua	NOUN
huacán ehua	huacán ehua	NOUN
huacápo	huacápo	NOUN
huan	huan	ADV
huanána	huanána	NOUN
huanín	huanín	NOUN
huanínxenia 	huanínxenia 	NOUN
huapínquenan	huapínquenan	NOUN
huapóro	huapóro	NOUN
huapóromaxca	huapóromaxca	NOUN
huapóropoinqui	huapóropoinqui	NOUN
huaquéti	huaquéti	VERB[I]
huaquín	huaquín	NOUN
huarán	huarán	NOUN
huaránca	huaránca	ADJ
huarápo	huarápo	NOUN
huaróca	huaróca	NOUN
huarón	huarón	ADJ
huaróro	huaróro	NOUN
huashíti	huashíti	VERB[T]
huasnón	huasnón	NOUN
huasányacati	huasányacati	NOUN
huaxmémpoco	huaxmémpoco	NOUN
huaxmén	huaxmén	NOUN
huaxá	huaxá	ADJ
huaxá	huaxá	NOUN
huaxáti	huaxáti	VERB[I]
huaín téetai	huaín téetai	NOUN
huecánhati	huecánhati	VERB[T]
huecánti	huecánti	VERB[I]
huecóti	huecóti	VERB[I]
huentánti	huentánti	VERB[T]
huenén	huenén	NOUN
huenénhati	huenénhati	VERB[T]
huenínti	huenínti	VERB[T]
hueníti	hueníti	VERB[I]
huequí	huequí	ADJ
huequí	huequí	NOUN
huequíti	huequíti	VERB[I]
hueránti	hueránti	VERB[T]
huesnáti	huesnáti	VERB[I]
huestí	huestí	ADJ
huestíora	huestíora	ADJ
huestíora ica	huestíora ica	NOUN
huestíoran jane	huestíoran jane	NOUN
huetsa	huetsa	ADV
huetá	huetá	NOUN
huexhuéx	huexhuéx	NOUN
huexá	huexá	NOUN
huexábita	huexábita	NOUN
huexácais	huexácais	NOUN
huexásama	huexásama	NOUN
huexáti	huexáti	VERB[I]
huexé	huexé	ADJ
huexé	huexé	NOUN
huexéti	huexéti	VERB[I]
hueyónti	hueyónti	VERB[T]
hueyóti	hueyóti	NOUN
hueyóti	hueyóti	VERB[I]
hueá	hueá	NOUN
hueán	hueán	NOUN
hueíti	hueíti	VERB[I]
hueóti	hueóti	VERB[I]
huihuán	huihuán	NOUN
huincás	huincás	ADJ
huincásti	huincásti	VERB[I]
huinónti	huinónti	VERB[T]
huinóti	huinóti	VERB[I]
huirácocha	huirácocha	NOUN
huirísh	huirísh	ADJ
huiríshati	huiríshati	VERB[T]
huiríshti	huiríshti	VERB[I]
huiróx	huiróx	NOUN
huishcónti	huishcónti	NOUN
huishnín	huishnín	NOUN
huishnínti	huishnínti	VERB[I]
huishtín	huishtín	NOUN
huishtín mexoai	huishtín mexoai	NOUN
huishtín paquetai	huishtín paquetai	NOUN
huishá	huishá	ADJ
huishá	huishá	NOUN
huishí	huishí	ADJ
huishí	huishí	NOUN
huishíti	huishíti	VERB[I]
huitá	huitá	NOUN
huitáx	huitáx	NOUN
huitóto	huitóto	NOUN
huáata 	huáata 	NOUN
huáati	huáati	VERB[I]
huáca	huáca	NOUN
huácabaque	huácabaque	NOUN
huácabene	huácabene	NOUN
huácanahua	huácanahua	NOUN
huácaxoma	huácaxoma	NOUN
huácho	huácho	ADJ
huáchoati	huáchoati	VERB[T]
huáco	huáco	NOUN
huái	huái	NOUN
huái ati	huái ati	VERB[T]
huáihuanti	huáihuanti	NOUN
huáiraonti	huáiraonti	NOUN
huáiroro	huáiroro	NOUN
huáiti	huáiti	NOUN
huáme	huáme	NOUN
huámebero	huámebero	NOUN
huáno	huáno	NOUN
huánomaati	huánomaati	VERB[T]
huánooma	huánooma	ADJ
huánoti	huánoti	NOUN
huánoti	huánoti	VERB[I]
huánoya	huánoya	ADJ
huánta	huánta	NOUN
huáoati	huáoati	VERB[T]
huáoiti	huáoiti	VERB[I]
huápa	huápa	NOUN
huápahuapa	huápahuapa	NOUN
huápi	huápi	NOUN
huáqueti	huáqueti	VERB[T]
huáqui	huáqui	NOUN
huárahuasco	huárahuasco	NOUN
huáraqueni	huáraqueni	NOUN
huári	huári	NOUN
huása	huása	NOUN
huásameeti	huásameeti	VERB[I]
huásananto	huásananto	NOUN
huásanti 	huásanti 	VERB[T]
huási	huási	NOUN
huásicaman chiáxca 	huásicaman chiáxca 	NOUN
huásimanan	huásimanan	NOUN
huáste	huáste	NOUN
huáxati	huáxati	VERB[T]
huéa	huéa	NOUN
huéati	huéati	VERB[T]
huémecaati	huémecaati	VERB[I]
huémeti	huémeti	VERB[T]
huéntameeti 	huéntameeti 	VERB[I]
huéonti	huéonti	VERB[T]
huérameeti	huérameeti	VERB[I]
huére	huére	ADJ
huésna	huésna	NOUN
huésnati	huésnati	VERB[T]
huétsa	huétsa	ADJ
huétsa	huétsa	NOUN
huétsa baquísh	huétsa baquísh	ADV
huéxacaati	huéxacaati	VERB[I]
huéxati	huéxati	NOUN
huéxati	huéxati	VERB[T]
huéxet	huéxet	VERB[T]
huía	huía	ADJ
huíaati	huíaati	VERB[T]
huíati	huíati	VERB[I]
huíiquiti	huíiquiti	VERB[I]
huínati	huínati	VERB[T]
huíni	huíni	ADJ
huíniti	huíniti	VERB[T]
huíno	huíno	NOUN
huínoti	huínoti	VERB[T]
huínti	huínti	NOUN
huípoco	huípoco	NOUN
huírita 	huírita 	NOUN
huísati	huísati	VERB[T]
huíshati	huíshati	VERB[T]
huíshmabaon tapán	huíshmabaon tapán	NOUN
huíshmabo	huíshmabo	NOUN
huíshpo	huíshpo	NOUN
huíshtininti	huíshtininti	NOUN
huísiti	huísiti	VERB[I]
huíso	huíso	ADJ
huíso	huíso	NOUN
huísoati	huísoati	VERB[T]
huísobimi	huísobimi	NOUN
huísoti	huísoti	VERB[T]
huísquiti	huísquiti	VERB[I]
i	i	NOUN
iba	iba	POSTP
iba	iba	NOUN
iba	iba	ADV
ibínti	ibínti	VERB[T]
ichán jane	ichán jane	NOUN
ichátama	ichátama	ADJ
icháti	icháti	VERB[T]
ichínca	ichínca	NOUN
ichínka	ichínka	NOUN
icáma	icáma	ADV
icára	icára	NOUN
icáxbi	icáxbi	ADV
icón	icón	ADJ
icón	icón	NOUN
icónhati	icónhati	VERB[T]
icóti	icóti	VERB[T]
ihuíntita 	ihuíntita 	NOUN
ijipito	ijipito	NOUN
ijipito 	ijipito 	NOUN
ikáma	ikáma	ADV
ikára	ikára	NOUN
ikáxbi	ikáxbi	ADV
ikí	ikí	ADV
ikíto	ikíto	NOUN
ikón	ikón	ADJ
ikón	ikón	NOUN
ikónhati	ikónhati	VERB[T]
ikóti	ikóti	VERB[T]
ima	ima	NOUN
impéiti	impéiti	NOUN
impíshti	impíshti	VERB[T]
imés	imés	ADJ
imí	imí	NOUN
imóshti	imóshti	VERB[T]
inbénti	inbénti	VERB[T]
inbésti	inbésti	VERB[T]
incarios	incarios	NOUN
inchán	inchán	ADJ
incháxti	incháxti	VERB[T]
inchóshti	inchóshti	VERB[T]
inchóti	inchóti	VERB[T]
incánto	incánto	NOUN
incósh	incósh	ADJ
inhuásti	inhuásti	VERB[T]
inhuáti	inhuáti	VERB[T]
inhuís	inhuís	ADJ
inhuíshti	inhuíshti	VERB[T]
inkarios	inkarios	NOUN
inkiratira	inkiratira	NOUN
inkirís	inkirís	ADJ
inkirís	inkirís	NOUN
inkánto	inkánto	NOUN
inkéxti	inkéxti	VERB[T]
inkósh	inkósh	ADJ
inpéti	inpéti	VERB[T]
inquiratira	inquiratira	NOUN
inquirís	inquirís	ADJ
inquirís	inquirís	NOUN
inquéxti	inquéxti	VERB[T]
inrásiti	inrásiti	VERB[I]
inrásiti 	inrásiti 	VERB[I]
inrénti	inrénti	VERB[T]
inréti	inréti	VERB[T]
inróti	inróti	VERB[I]
insénti	insénti	VERB[T]
intsáti	intsáti	VERB[T]
intséti	intséti	VERB[T]
intsónti	intsónti	VERB[T]
intsósti	intsósti	VERB[T]
intásti	intásti	VERB[T]
intáxti	intáxti	VERB[T]
intésiti	intésiti	VERB[I]
intésti	intésti	VERB[T]
intéti	intéti	VERB[T]
intírinan	intírinan	NOUN
intírinan 	intírinan 	NOUN
intíro	intíro	ADJ
intíro 	intíro 	ADJ
intó	intó	NOUN
intóshti	intóshti	VERB[T]
intóti	intóti	VERB[I]
inwásti	inwásti	VERB[T]
inwáti	inwáti	VERB[T]
inwís	inwís	ADJ
inwíshti	inwíshti	VERB[T]
inxaxti	inxaxti	VERB[T]
inxóxti	inxóxti	VERB[T]
iná	iná	NOUN
ináati	ináati	VERB[T]
inánti	inánti	VERB[T]
inário	inário	NOUN
ináti	ináti	VERB[I]
inéxti	inéxti	VERB[T]
iníchinti	iníchinti	NOUN
inín	inín	ADJ
inínhati	inínhati	VERB[T]
inínti	inínti	VERB[I]
inón janxóxoti	inón janxóxoti	NOUN
ipón ehua	ipón ehua	NOUN
ipón ewa	ipón ewa	NOUN
ipóri	ipóri	NOUN
iquí	iquí	ADV
iquíto	iquíto	NOUN
iri sf.	iri sf.	VERB[I]
iribin	iribin	NOUN
iribira	iribira	NOUN
irín	irín	NOUN
iscóro 	iscóro 	NOUN
ishkín	ishkín	NOUN
ishmín	ishmín	NOUN
ishquín	ishquín	NOUN
ishtíba	ishtíba	NOUN
ishtón ati	ishtón ati	VERB[T]
ishtónshoco	ishtónshoco	ADV
ishtónshoko	ishtónshoko	ADV
ishtónti	ishtónti	VERB[I]
ishísh	ishísh	NOUN
ishó	ishó	NOUN
iskénhati	iskénhati	VERB[T]
iskénti	iskénti	VERB[I]
iskéti	iskéti	VERB[I]
iskóro	iskóro	NOUN
isma	isma	ADV
ispánya	ispánya	NOUN
ispánya 	ispánya 	NOUN
ispányoro	ispányoro	ADJ
ispára	ispára	NOUN
ispíco	ispíco	NOUN
ispíko	ispíko	NOUN
ispín	ispín	NOUN
ispíntano	ispíntano	NOUN
isquénhati	isquénhati	VERB[T]
isquénti 	isquénti 	VERB[I]
isquéti	isquéti	VERB[I]
isá	isá	NOUN
isán	isán	NOUN
isánbero	isánbero	NOUN
isín	isín	ADJ
isín	isín	NOUN
isínhati	isínhati	VERB[T]
isínti	isínti	VERB[I]
isón ehua	isón ehua	NOUN
isón ewa	isón ewa	NOUN
isóntita	isóntita	NOUN
isónxanhex	isónxanhex	NOUN
isónxoma	isónxoma	NOUN
isónyonken	isónyonken	NOUN
isónyonquen	isónyonquen	NOUN
iti sf.	iti sf.	VERB[I]
itsón	itsón	NOUN
itántanta	itántanta	NOUN
itária	itária	NOUN
itásbo	itásbo	ADJ
iwíntita	iwíntita	NOUN
ixné	ixné	NOUN
ián	ián	NOUN
iáti	iáti	VERB[T]
ién	ién	ADJ
ja	ja	ADJ
ja	ja	PRON
jabákinti	jabákinti	VERB[I]
jabáquinti	jabáquinti	VERB[I]
jabáti	jabáti	VERB[I]
jabénane	jabénane	ADJ
jabísati	jabísati	VERB[T]
jabísati 	jabísati 	VERB[T]
jabísti	jabísti	VERB[I]
jabísti 	jabísti 	VERB[I]
jabón	jabón	NOUN
jabón 	jabón 	NOUN
jachón	jachón	NOUN
jachón 	jachón 	NOUN
jacóma	jacóma	ADJ
jacómati	jacómati	VERB[T]
jacómayora	jacómayora	ADJ
jacón	jacón	ADJ
jacónhati	jacónhati	VERB[T]
jacónresi	jacónresi	ADV
jacónshoco	jacónshoco	ADJ
jacónti	jacónti	VERB[I]
jahuen	jahuen	ADJ
jahuén	jahuén	PRON
jahuéqui	jahuéqui	NOUN
jahuéqui acai	jahuéqui acai	ADJ
jahuéqui quimisha paroya	jahuéqui quimisha paroya	NOUN
jahuéqui tsamanti xobo	jahuéqui tsamanti xobo	NOUN
jahuéquia	jahuéquia	ADJ
jahuéquiacasti	jahuéquiacasti	VERB[T]
jahuéquiaoma	jahuéquiaoma	ADJ
jahuéquiati	jahuéquiati	VERB[T]
jain póiti	jain póiti	NOUN
jakóma	jakóma	ADJ
jakómati	jakómati	VERB[T]
jakómayora	jakómayora	ADJ
jakón	jakón	ADJ
jakónhati	jakónhati	VERB[T]
jakónresi	jakónresi	ADV
jakónshoko	jakónshoko	ADJ
jakónti	jakónti	VERB[I]
jampásti	jampásti	VERB[T]
jampéti	jampéti	VERB[T]
jampís	jampís	ADJ
jampíshti	jampíshti	VERB[T]
jampóti	jampóti	VERB[T]
jamá	jamá	NOUN
jamámati	jamámati	NOUN
jamáti	jamáti	VERB[T]
jamíti	jamíti	VERB[T]
jamóshti	jamóshti	VERB[T]
jamóti	jamóti	VERB[I]
janbíti	janbíti	VERB[T]
janchéxti	janchéxti	VERB[T]
janchínti	janchínti	VERB[T]
janchíti	janchíti	VERB[T]
janchópeti	janchópeti	VERB[I]
janchóshti	janchóshti	VERB[T]
janchóti	janchóti	VERB[T]
jancósh	jancósh	ADJ
jankénhati	jankénhati	VERB[T]
jankénti	jankénti	VERB[I]
jankéxti	jankéxti	VERB[T]
jankósh	jankósh	ADJ
janquénhati	janquénhati	VERB[T]
janquénti	janquénti	VERB[I]
janquéxti	janquéxti	VERB[T]
janrásati	janrásati	VERB[I]
janréti	janréti	VERB[T]
jansénti	jansénti	VERB[T]
jansíti	jansíti	VERB[T]
jantsáti	jantsáti	VERB[T]
jantséti	jantséti	VERB[T]
jantsínti	jantsínti	VERB[I]
jantásti	jantásti	VERB[T]
jantéti	jantéti	VERB[T]
jantínti	jantínti	VERB[T]
janxbáti	janxbáti	VERB[T]
janxáxti	janxáxti	VERB[T]
janxóxpo	janxóxpo	NOUN
janxóxti	janxóxti	VERB[T]
janén janetitianbi jane	janén janetitianbi jane	NOUN
janénti	janénti	VERB[T]
janéti	janéti	VERB[I]
janín	janín	NOUN
jaréti	jaréti	VERB[T]
jascá	jascá	ADV
jascáquetian	jascáquetian	ADV
jascáti	jascáti	VERB[I]
jaská	jaská	ADV
jaskáketian	jaskáketian	ADV
jaskáti	jaskáti	VERB[I]
jasín	jasín	NOUN
jasínkene	jasínkene	NOUN
jasínquene	jasínquene	NOUN
jaton	jaton	ADJ
jatsánhati	jatsánhati	VERB[T]
jatsánti	jatsánti	VERB[I]
jatí	jatí	ADJ
jatí	jatí	ADV
jatíbi	jatíbi	ADJ
jatíbiain	jatíbiain	ADV
jatíbitian	jatíbitian	ADV
jatíribi	jatíribi	ADJ
jawen	jawen	ADJ
jawéki	jawéki	NOUN
jawéki akai	jawéki akai	ADJ
jawéki kimisha paroya	jawéki kimisha paroya	NOUN
jawéki tsamanti xobo	jawéki tsamanti xobo	NOUN
jawékia	jawékia	ADJ
jawékiakasti	jawékiakasti	VERB[T]
jawékiaoma	jawékiaoma	ADJ
jawékiati	jawékiati	VERB[T]
jawén	jawén	PRON
jaxcati	jaxcati	VERB[I]
jaxcá	jaxcá	NOUN
jaxkati	jaxkati	VERB[I]
jaxká	jaxká	NOUN
jayáoma	jayáoma	ADJ
jaákinbicho	jaákinbicho	ADV
jaáquinbicho	jaáquinbicho	ADV
jaímashoco	jaímashoco	ADV
jaímashoko	jaímashoko	ADV
jaín	jaín	ADV
jaó	jaó	ADV
jencó	jencó	ADJ
jencóati	jencóati	VERB[T]
jencóti	jencóti	VERB[I]
jenkó	jenkó	ADJ
jenkóati	jenkóati	VERB[T]
jenkóti	jenkóti	VERB[I]
jenén ehua	jenén ehua	NOUN
jenén ewa	jenén ewa	NOUN
jenénbimpish	jenénbimpish	NOUN
jenéntita	jenéntita	NOUN
jenényahua	jenényahua	NOUN
jenényawa	jenényawa	NOUN
jenéti	jenéti	VERB[I]
jesté	jesté	ADJ
jestéati	jestéati	VERB[T]
jestéti	jestéti	VERB[I]
jeté	jeté	NOUN
jeó	jeó	NOUN
jibón	jibón	NOUN
jihuéati	jihuéati	VERB[T]
jihuéti	jihuéti	VERB[I]
jimpán	jimpán	NOUN
jimpásh	jimpásh	ADJ
jimpís	jimpís	ADJ
jimés	jimés	ADJ
jinbésti	jinbésti	VERB[T]
jinchán	jinchán	NOUN
jinchéxti	jinchéxti	VERB[T]
jinchíti	jinchíti	VERB[T]
jinchóti	jinchóti	VERB[T]
jincósh	jincósh	ADJ
jinké	jinké	NOUN
jinkósh	jinkósh	ADJ
jinqué	jinqué	NOUN
jintséti	jintséti	VERB[T]
jintsínti	jintsínti	VERB[I]
jintá	jintá	NOUN
jintínti	jintínti	VERB[T]
jintó	jintó	NOUN
jinxáxti	jinxáxti	VERB[T]
jinán ehua	jinán ehua	NOUN
jinán ewa	jinán ewa	NOUN
jiráfa	jiráfa	NOUN
jishténhati	jishténhati	VERB[T]
jishténhati 	jishténhati 	VERB[T]
jishténti	jishténti	VERB[T]
jishténti 	jishténti 	VERB[T]
jisá	jisá	NOUN
jisákeska	jisákeska	POSTP
jisáquesca	jisáquesca	POSTP
jisé	jisé	VERB[T]
jisís	jisís	NOUN
jisón	jisón	NOUN
jisónti	jisónti	VERB[I]
jisós	jisós	NOUN
jisós 	jisós 	NOUN
jiwéati	jiwéati	VERB[T]
jiwéti	jiwéti	VERB[I]
jo	jo	ADV
jo 	jo 	ADV
jobóxco	jobóxco	NOUN
jobóxko	jobóxko	NOUN
jocáti	jocáti	VERB[I]
jocónhati	jocónhati	VERB[I]
jocónti	jocónti	VERB[I]
johuéati	johuéati	VERB[T]
johuéicai	johuéicai	ADJ
johuéiti	johuéiti	VERB[I]
jojóati	jojóati	VERB[T]
jojóiti	jojóiti	VERB[I]
jokáti	jokáti	VERB[I]
jokónhati	jokónhati	VERB[I]
jokónti	jokónti	VERB[I]
joméxti	joméxti	VERB[T]
jomó	jomó	NOUN
jonbésti	jonbésti	VERB[T]
jonbón	jonbón	NOUN
joncánhati	joncánhati	VERB[T]
joncánti	joncánti	VERB[I]
joncósh	joncósh	ADJ
jonkánhati	jonkánhati	VERB[T]
jonkánti	jonkánti	VERB[I]
jonkéxti	jonkéxti	VERB[T]
jonkósh	jonkósh	ADJ
jonquéxti	jonquéxti	VERB[T]
jontséti	jontséti	VERB[T]
jontóshti	jontóshti	VERB[T]
jonéshoco	jonéshoco	ADJ
jonéshoko	jonéshoko	ADJ
jonéshti	jonéshti	VERB[T]
jonéti	jonéti	VERB[I]
joníiti	joníiti	VERB[I]
jonónjoboxco	jonónjoboxco	NOUN
jonónjoboxko	jonónjoboxko	NOUN
jopémati	jopémati	VERB[T]
jopéti	jopéti	VERB[T]
jopóx	jopóx	NOUN
jorínti	jorínti	VERB[I]
jorío	jorío	NOUN
jorío 	jorío 	NOUN
joríoma	joríoma	NOUN
joríoma 	joríoma 	NOUN
joshímati	joshímati	VERB[T]
joshín	joshín	ADJ
joshín oxná	joshín oxná	ADJ
joshínhati	joshínhati	VERB[T]
joshínjihui	joshínjihui	NOUN
joshínjiwi	joshínjiwi	NOUN
joshínti	joshínti	VERB[I]
josí	josí	NOUN
josí 	josí 	NOUN
jotocóiti	jotocóiti	VERB[I]
jotokóiti	jotokóiti	VERB[I]
jotíti	jotíti	VERB[I]
jotóati	jotóati	VERB[T]
jowéati	jowéati	VERB[T]
jowéikai	jowéikai	ADJ
jowéiti	jowéiti	VERB[I]
joxicá	joxicá	NOUN
joxiká	joxiká	NOUN
joyó	joyó	NOUN
joyónti	joyónti	VERB[T]
joyóti	joyóti	VERB[I]
joéati	joéati	VERB[T]
joéti	joéti	VERB[I]
joín	joín	NOUN
joín imamis	joín imamis	NOUN
joínti	joínti	NOUN
joínti	joínti	VERB[T]
jába	jába	NOUN
jábicho	jábicho	ADJ
jábicho	jábicho	PRON
jáca 	jáca 	NOUN
jáconi	jáconi	ADV
jácopi	jácopi	ADV
jáhue	jáhue	PRON
jáhueaqui	jáhueaqui	ADV
jáhueati	jáhueati	ADV
jáhuebi	jáhuebi	PRON
jáhuebioma	jáhuebioma	ADJ
jáhuecopi	jáhuecopi	ADV
jáhuemeax	jáhuemeax	ADV
jáhuequesca	jáhuequesca	ADV
jáhuequescaati	jáhuequescaati	VERB[T]
jáhuequescarain	jáhuequescarain	ADV
jáhuequescatax	jáhuequescatax	ADV
jáhuequescati	jáhuequescati	ADV
jáhuequescati	jáhuequescati	VERB[I]
jáhuerano	jáhuerano	ADV
jáhuerao	jáhuerao	ADV
jáhuerato	jáhuerato	PRON
jáhuetian	jáhuetian	ADV
jáhuetianbi	jáhuetianbi	ADV
jáhuetii	jáhuetii	ADJ
jáhuetio	jáhuetio	ADV
jáinoa	jáinoa	ADV
jáinoax	jáinoax	ADV
jáka	jáka	NOUN
jákiribi	jákiribi	ADV
jákoni	jákoni	ADV
jákopi	jákopi	ADV
jámpono	jámpono	NOUN
jána	jána	NOUN
jánaca	jánaca	NOUN
jánaka	jánaka	NOUN
jánatapon	jánatapon	NOUN
jánati	jánati	VERB[T]
jánchicooti 	jánchicooti 	VERB[I]
jánchikooti	jánchikooti	VERB[I]
jánchiti	jánchiti	VERB[I]
jánchokiiti	jánchokiiti	VERB[I]
jánchoquiiti	jánchoquiiti	VERB[I]
jánchoshiiti	jánchoshiiti	VERB[I]
jáne	jáne	NOUN
jánecon	jánecon	NOUN
jánekon	jánekon	NOUN
jáneteki	jáneteki	NOUN
jánetequi	jánetequi	NOUN
jáneti	jáneti	VERB[T]
jániti	jániti	VERB[T]
jánoti	jánoti	VERB[T]
jánsho	jánsho	NOUN
jánshoti	jánshoti	VERB[I]
jánso	jánso	ADJ
jánso	jánso	NOUN
jánsoti	jánsoti	VERB[T]
jánto	jánto	ADJ
jánxo	jánxo	ADJ
jánxo	jánxo	NOUN
jáquiribi	jáquiribi	ADV
járamasia	járamasia	NOUN
jáscara	jáscara	ADJ
jáscara	jáscara	PRON
jáscatax	jáscatax	ADV
jáscati	jáscati	ADV
jáshi	jáshi	NOUN
jáskara	jáskara	ADJ
jáskara	jáskara	PRON
jáskatax	jáskatax	ADV
jáskati	jáskati	ADV
játi	játi	NOUN
játi	játi	VERB[I]
játian	játian	ADV
játicaxbi	játicaxbi	ADV
játikaxbi	játikaxbi	ADV
játio	játio	ADV
játishaniti	játishaniti	VERB[I]
játo	játo	PRON
játo 	játo 	PRON
játsa	játsa	ADJ
játsa 	játsa 	ADJ
jáwe	jáwe	PRON
jáweaki	jáweaki	ADV
jáweati	jáweati	ADV
jáwebi	jáwebi	PRON
jáwebioma	jáwebioma	ADJ
jáwekeska	jáwekeska	ADV
jáwekeskaati	jáwekeskaati	VERB[T]
jáwekeskarain	jáwekeskarain	ADV
jáwekeskatax	jáwekeskatax	ADV
jáwekeskati	jáwekeskati	ADV
jáwekeskati	jáwekeskati	VERB[I]
jáwekopi	jáwekopi	ADV
jáwemeax	jáwemeax	ADV
jáwerano	jáwerano	ADV
jáwerao	jáwerao	ADV
jáwerato	jáwerato	PRON
jáwetian	jáwetian	ADV
jáwetianbi	jáwetianbi	ADV
jáwetii	jáwetii	ADJ
jáwetio	jáwetio	ADV
jáxcati	jáxcati	VERB[T]
jáxkati	jáxkati	VERB[T]
jée	jée	NOUN
jéma	jéma	NOUN
jéma xabá	jéma xabá	NOUN
jémaati	jémaati	VERB[T]
jémashoco	jémashoco	NOUN
jémashoko	jémashoko	NOUN
jémati	jémati	VERB[I]
jén ati	jén ati	VERB[T]
jén iti	jén iti	VERB[I]
jéne	jéne	NOUN
jéne máanai	jéne máanai	NOUN
jénecahue	jénecahue	NOUN
jénekawe	jénekawe	NOUN
jéneti	jéneti	VERB[T]
jénetia	jénetia	NOUN
jénetian	jénetian	ADV
jénetiati	jénetiati	VERB[I]
jépe	jépe	NOUN
jéshati	jéshati	VERB[T]
jéshi	jéshi	NOUN
jésiti	jésiti	VERB[I]
jéteti	jéteti	VERB[I]
jéxco	jéxco	NOUN
jéxko	jéxko	NOUN
jíhui	jíhui	NOUN
jíhui xáquiti	jíhui xáquiti	NOUN
jíhuimaxca	jíhuimaxca	NOUN
jíi	jíi	NOUN
jíkimati	jíkimati	VERB[T]
jíkiti	jíkiti	VERB[I]
jíma	jíma	NOUN
jími	jími	NOUN
jímiti	jímiti	VERB[I]
jína	jína	NOUN
jínaoma	jínaoma	ADJ
jínchiti	jínchiti	VERB[I]
jíncho	jíncho	ADJ
jínhuachori	jínhuachori	NOUN
jínto	jínto	ADJ
jínwachori	jínwachori	NOUN
jínxteti	jínxteti	VERB[T]
jíquimati	jíquimati	VERB[T]
jíquiti	jíquiti	VERB[I]
jíria	jíria	ADJ
jíriati	jíriati	VERB[T]
jírioma	jírioma	ADJ
jíriribiti	jíriribiti	VERB[I]
jíriti	jíriti	VERB[I]
jíshaman	jíshaman	ADV
jíshti	jíshti	ADJ
jíshtima	jíshtima	ADJ
jísokiristo	jísokiristo	NOUN
jísoquiristo 	jísoquiristo 	NOUN
jísti	jísti	VERB[T]
jíwi	jíwi	NOUN
jíwi xákiti	jíwi xákiti	NOUN
jíwimaxka	jíwimaxka	NOUN
jóa	jóa	NOUN
jóati	jóati	VERB[I]
jóati	jóati	VERB[T]
jóbo	jóbo	NOUN
jóboati	jóboati	VERB[T]
jóboti	jóboti	VERB[I]
jóca	jóca	NOUN
jócati	jócati	VERB[T]
jóchi	jóchi	NOUN
jócona	jócona	NOUN
jói	jói	NOUN
jóicoma	jóicoma	ADJ
jóikoma	jóikoma	ADJ
jóioma	jóioma	ADJ
jóka	jóka	NOUN
jókati	jókati	VERB[T]
jókona	jókona	NOUN
jóncho	jóncho	ADJ
jóncho	jóncho	NOUN
jóneti	jóneti	VERB[T]
jóni	jóni	NOUN
jóni réteai	jóni réteai	NOUN
jóniati	jóniati	VERB[T]
jónicaman	jónicaman	NOUN
jónicaraniro	jónicaraniro	NOUN
jónicon	jónicon	NOUN
jónihuaca	jónihuaca	NOUN
jóniino	jóniino	NOUN
jónikaman	jónikaman	NOUN
jónikaraniro	jónikaraniro	NOUN
jónikon	jónikon	NOUN
jónimati	jónimati	VERB[T]
jónishoco	jónishoco	NOUN
jónishoko	jónishoko	NOUN
jóniti	jóniti	VERB[I]
jóniwaka	jóniwaka	NOUN
jóno	jóno	NOUN
jónoti	jónoti	NOUN
jónoti	jónoti	VERB[T]
jónxe	jónxe	NOUN
jóo	jóo	NOUN
jóra,	jóra,	NOUN
jóra, 	jóra, 	NOUN
jórati	jórati	VERB[I]
jórati 	jórati 	VERB[I]
jóri	jóri	NOUN
jóro	jóro	NOUN
jóso	jóso	NOUN
jósporo	jósporo	NOUN
jóta	jóta	NOUN
jóti	jóti	VERB[I]
jóti 	jóti 	VERB[I]
jótiti	jótiti	VERB[T]
jóto	jóto	NOUN
jóxo	jóxo	ADJ
jóxoati	jóxoati	VERB[T]
jóxoti	jóxoti	VERB[I]
ka	ka	ADV
ka	ka	NOUN
kabáyo	kabáyo	NOUN
kabésti	kabésti	VERB[T]
kabéx	kabéx	ADJ
kabínhati	kabínhati	VERB[T]
kabínti	kabínti	VERB[I]
kabóri	kabóri	NOUN
kabórinimpiti	kabórinimpiti	NOUN
kachán	kachán	NOUN
kacháxti	kacháxti	VERB[T]
kain	kain	ADV
kají	kají	NOUN
kajónshoko	kajónshoko	NOUN
kakán	kakán	NOUN
kakín	kakín	NOUN
kaman	kaman	POSTP
kampánya	kampánya	NOUN
kamán	kamán	NOUN
kamári	kamári	NOUN
kamés	kamés	ADJ
kaméxti	kaméxti	VERB[T]
kamícho	kamícho	NOUN
kamís	kamís	NOUN
kamíti	kamíti	VERB[I]
kamósti	kamósti	VERB[T]
kamóx	kamóx	NOUN
kan	kan	ADV
kanará	kanará	NOUN
kanchán	kanchán	NOUN
kanchónhati	kanchónhati	VERB[T]
kankámporo	kankámporo	NOUN
kankán	kankán	NOUN
kankóro	kankóro	NOUN
kanshín	kanshín	ADJ
kanshínti	kanshínti	VERB[I]
kantsín	kantsín	NOUN
kantína	kantína	NOUN
kaná	kaná	NOUN
kanán ewa	kanán ewa	NOUN
kanántancho	kanántancho	NOUN
kanánti	kanánti	VERB[T]
kanás	kanás	NOUN
kanéna	kanéna	NOUN
kanéxti	kanéxti	VERB[T]
kanóti	kanóti	NOUN
kapábo	kapábo	NOUN
kapé	kapé	NOUN
kapé koi	kapé koi	NOUN
kapéshin	kapéshin	NOUN
kapéti	kapéti	VERB[I]
kapéti	kapéti	VERB[T]
kapín	kapín	NOUN
kapónhati	kapónhati	VERB[T]
kapóti	kapóti	VERB[I]
kapóti	kapóti	VERB[T]
karibó	karibó	NOUN
karájon	karájon	NOUN
karánbeti	karánbeti	VERB[T]
karéko	karéko	NOUN
karínan	karínan	NOUN
karíti	karíti	NOUN
karó	karó	NOUN
karónchempan	karónchempan	NOUN
karós	karós	NOUN
kas	kas	ADV
kashímpo	kashímpo	NOUN
kashóati	kashóati	VERB[T]
kastíkameeti	kastíkameeti	VERB[I]
kastíkanti	kastíkanti	VERB[T]
kastíko	kastíko	NOUN
kastóro	kastóro	NOUN
kasórina	kasórina	NOUN
kato	kato	ADV
katsáti	katsáti	VERB[I]
katsáti	katsáti	VERB[T]
katséti	katséti	VERB[T]
katásho	katásho	NOUN
katáxti	katáxti	VERB[T]
katéti	katéti	VERB[T]
katóriko	katóriko	ADJ
katóti	katóti	VERB[T]
katóxko	katóxko	NOUN
kawá	kawá	NOUN
kawánti	kawánti	VERB[I]
kawáti	kawáti	NOUN
kawáti	kawáti	VERB[T]
kawé ati	kawé ati	VERB[T]
kawín	kawín	NOUN
kawís	kawís	ADJ
kawíshpo	kawíshpo	NOUN
kaxbá	kaxbá	NOUN
kaxkéti	kaxkéti	VERB[I]
kaxkíti	kaxkíti	VERB[I]
kaxtéti	kaxtéti	VERB[I]
kaya	kaya	ADV
kayánari	kayánari	NOUN
kayária	kayária	NOUN
kaéxiti	kaéxiti	VERB[I]
kaéxkaesh	kaéxkaesh	NOUN
kaíai	kaíai	ADJ
kaíati	kaíati	VERB[T]
kaíbo	kaíbo	NOUN
kaímito	kaímito	NOUN
kaín	kaín	NOUN
kaíns	kaíns	NOUN
kaís	kaís	NOUN
kaíti	kaíti	VERB[I]
ke	ke	NOUN
kea	kea	POSTP
kean	kean	ADV
kebá	kebá	NOUN
kebáwa	kebáwa	NOUN
kebénokooti	kebénokooti	VERB[I]
kebénti	kebénti	VERB[T]
kebésti	kebésti	VERB[T]
kebéx	kebéx	ADJ
kebís	kebís	ADJ
kebíti	kebíti	NOUN
kebóx	kebóx	ADJ
kecháti	kecháti	VERB[T]
kechéxti	kechéxti	VERB[T]
kechínti	kechínti	VERB[T]
kechónti	kechónti	VERB[T]
kechóti	kechóti	VERB[T]
kekénti	kekénti	VERB[T]
kekéxti	kekéxti	VERB[I]
kekó	kekó	NOUN
kekósh	kekósh	ADJ
kekóti	kekóti	NOUN
kekóti	kekóti	VERB[I]
kemexti	kemexti	VERB[T]
kempís	kempís	ADJ
kempís	kempís	NOUN
kempó	kempó	ADJ
kempó	kempó	NOUN
kempóya	kempóya	ADJ
kemánti	kemánti	VERB[T]
kemóntanti	kemóntanti	VERB[T]
kemóshti	kemóshti	VERB[T]
kemósti	kemósti	VERB[T]
kemóti	kemóti	VERB[I]
kenchá	kenchá	NOUN
kenchéx	kenchéx	ADJ
kenchónti	kenchónti	VERB[I]
kenchóntinti	kenchóntinti	VERB[I]
kenkéx	kenkéx	NOUN
kentí	kentí	NOUN
kenán	kenán	NOUN
kenáti	kenáti	VERB[I]
kenéati	kenéati	VERB[T]
kenéti	kenéti	VERB[I]
kenéxti	kenéxti	VERB[T]
kenéya	kenéya	ADJ
keníti	keníti	VERB[I]
kepásti	kepásti	VERB[T]
kepínti	kepínti	VERB[I]
kepíshiiti	kepíshiiti	VERB[I]
kepíshti	kepíshti	VERB[T]
kepíti	kepíti	VERB[I]
kerás	kerás	ADJ
kerásati	kerásati	VERB[T]
kerásma	kerásma	ADJ
kerásti	kerásti	VERB[T]
keré	keré	NOUN
keréati	keréati	VERB[T]
kerénti	kerénti	VERB[T]
kerés ati	kerés ati	VERB[T]
keréti	keréti	VERB[T]
keréx	keréx	ADJ
keréxatí	keréxatí	VERB[T]
keréxmeske	keréxmeske	NOUN
keréxti	keréxti	VERB[I]
keríro	keríro	NOUN
kerón iti	kerón iti	VERB[I]
keróti	keróti	VERB[T]
keróxati	keróxati	VERB[T]
keshkánti	keshkánti	VERB[T]
keshkáti	keshkáti	VERB[I]
keshmón	keshmón	ADJ
keshtínti	keshtínti	VERB[T]
keshtíti	keshtíti	VERB[I]
kesháati	kesháati	NOUN
keshánti	keshánti	VERB[T]
keska	keska	POSTP
keskáakin	keskáakin	POSTP
keskáati	keskáati	VERB[T]
kespín	kespín	NOUN
kespó	kespó	ADJ
kespóti	kespóti	VERB[T]
kestáti	kestáti	VERB[I]
kestén	kestén	ADJ
kesténhati	kesténhati	VERB[T]
kesénti	kesénti	VERB[T]
kesés	kesés	ADJ
kesíati	kesíati	VERB[T]
kesín	kesín	NOUN
kesínti	kesínti	VERB[T]
ketsámaati	ketsámaati	VERB[T]
ketsán ati	ketsán ati	VERB[T]
ketsán iti	ketsán iti	VERB[I]
ketsánti	ketsánti	VERB[T]
ketséti	ketséti	VERB[T]
ketsósti	ketsósti	VERB[T]
ketánti	ketánti	VERB[T]
ketáshati	ketáshati	VERB[T]
ketásti	ketásti	VERB[T]
ketáxiti	ketáxiti	VERB[I]
ketáxti	ketáxti	VERB[T]
ketéati	ketéati	VERB[T]
ketéti	ketéti	VERB[I]
ketéti	ketéti	VERB[T]
ketínti	ketínti	VERB[T]
ketó	ketó	NOUN
ketóshti	ketóshti	VERB[T]
kewáti	kewáti	VERB[T]
kewé	kewé	NOUN
kewéati	kewéati	VERB[T]
kewéxti	kewéxti	VERB[T]
kewéya	kewéya	ADJ
kewínti	kewínti	VERB[T]
kewíti	kewíti	VERB[I]
kexbó	kexbó	NOUN
kexbón	kexbón	NOUN
kexkánti	kexkánti	VERB[I]
kexmíti	kexmíti	VERB[I]
kexpán	kexpán	ADJ
kextéti	kextéti	VERB[I]
kextó	kextó	ADJ
kextó	kextó	NOUN
kextóma	kextóma	ADJ
kextóti	kextóti	VERB[I]
kexá	kexá	ADV
kexá	kexá	POSTP
kexáti	kexáti	VERB[I]
kexáxti	kexáxti	VERB[T]
kexéti	kexéti	VERB[I]
kexóti	kexóti	VERB[T]
kexóxti	kexóxti	VERB[I]
keyá	keyá	ADJ
keyá	keyá	NOUN
keyáati	keyáati	VERB[T]
keyánti	keyánti	VERB[T]
keyáti	keyáti	VERB[I]
keyén	keyén	ADJ
keyón	keyón	NOUN
keyósh	keyósh	ADJ
keyóti	keyóti	VERB[I]
keíba	keíba	ADV
keíba	keíba	POSTP
keó	keó	NOUN
keónti	keónti	VERB[T]
keóti	keóti	VERB[I]
keóx	keóx	ADJ
ki	ki	POSTP
ki	ki	ADV
kibéntí	kibéntí	VERB[T]
kibésti	kibésti	VERB[T]
kibíti	kibíti	VERB[T]
kibón	kibón	NOUN
kicháti	kicháti	VERB[T]
kicháxti	kicháxti	VERB[T]
kichí	kichí	NOUN
kichírimina	kichírimina	NOUN
kichírimo	kichírimo	NOUN
kichíti	kichíti	VERB[I]
kichóshti	kichóshti	VERB[T]
kikénti	kikénti	VERB[T]
kikéxti	kikéxti	VERB[T]
kikín	kikín	ADJ
kikín	kikín	ADV
kikínhati	kikínhati	VERB[T]
kikínti	kikínti	VERB[I]
kikósh	kikósh	ADJ
kimánti	kimánti	VERB[T]
kimés	kimés	ADJ
kiméxti	kiméxti	VERB[T]
kimóshti	kimóshti	VERB[T]
kin	kin	ADV
kintósti	kintósti	VERB[T]
kinxón	kinxón	NOUN
kinán	kinán	NOUN
kinánkasti	kinánkasti	VERB[I]
kinánti	kinánti	VERB[T]
kinéxti	kinéxti	VERB[T]
kipásti	kipásti	VERB[T]
kipí	kipí	NOUN
kipíshti	kipíshti	VERB[T]
kipón	kipón	NOUN
kipóti	kipóti	VERB[I]
kiran	kiran	ADV
kirínika	kirínika	NOUN
kirínko	kirínko	NOUN
kirípi	kirípi	NOUN
kirípinin iti	kirípinin iti	VERB[I]
kirísto	kirísto	NOUN
kishpímeeti	kishpímeeti	VERB[T]
kishpínti	kishpínti	VERB[T]
kiskíti	kiskíti	VERB[I]
kismón	kismón	ADJ
kisós	kisós	NOUN
kitsánti	kitsánti	VERB[T]
kitséti	kitséti	VERB[T]
kitsínti	kitsínti	VERB[I]
kitsíti	kitsíti	VERB[T]
kitsónti	kitsónti	VERB[T]
kitsósti	kitsósti	VERB[T]
kitára	kitára	NOUN
kitásti	kitásti	VERB[T]
kitéti	kitéti	VERB[T]
kitéxti	kitéxti	VERB[I]
kitísati	kitísati	VERB[T]
kitísiti	kitísiti	VERB[I]
kitósati	kitósati	VERB[T]
kitóshti	kitóshti	VERB[I]
kitósiti	kitósiti	VERB[I]
kiwásti	kiwásti	VERB[T]
kiwáti	kiwáti	VERB[T]
kiwéxti	kiwéxti	VERB[T]
kiwís	kiwís	ADJ
kiwíshti	kiwíshti	VERB[T]
kixaxti	kixaxti	VERB[T]
kixpé	kixpé	ADJ
kixtéti	kixtéti	VERB[I]
kién	kién	ADJ
kiósh	kiósh	ADJ
kióx	kióx	ADJ
kobínhati	kobínhati	VERB[T]
kobínti	kobínti	VERB[I]
kobís	kobís	ADJ
kobítaxti	kobítaxti	VERB[T]
kobóati	kobóati	VERB[T]
kobóiti	kobóiti	VERB[I]
kochára	kochára	NOUN
kochón	kochón	ADJ
kochónti	kochónti	VERB[T]
kokoríiti	kokoríiti	VERB[I]
kokáiki isáni	kokáiki isáni	NOUN
kokáme	kokáme	NOUN
kokán awin	kokán awin	NOUN
kokáracha	kokáracha	NOUN
komán	komán	NOUN
komán ewa	komán ewa	NOUN
komári	komári	NOUN
komárinia	komárinia	NOUN
komén	komén	NOUN
koméxti	koméxti	VERB[T]
komíko	komíko	NOUN
komón ati	komón ati	VERB[T]
komón iti	komón iti	VERB[I]
kon	kon	ADV
konjíti	konjíti	NOUN
konkísh	konkísh	NOUN
konkón	konkón	NOUN
konrón	konrón	NOUN
kontá	kontá	NOUN
konxán	konxán	NOUN
konésati	konésati	VERB[T]
koníjo	koníjo	NOUN
konín ewa	konín ewa	NOUN
konónbi	konónbi	NOUN
kopi	kopi	POSTP
kopén	kopén	NOUN
kopéti	kopéti	VERB[T]
kopí	kopí	ADJ
kopí	kopí	NOUN
kopíati	kopíati	VERB[T]
kopíma	kopíma	ADJ
kopíti	kopíti	VERB[I]
kopítso	kopítso	NOUN
korá	korá	ADJ
korá	korá	NOUN
koráati	koráati	VERB[T]
koráka	koráka	NOUN
korário	korário	NOUN
koráti	koráti	VERB[I]
koríchi	koríchi	NOUN
koríki	koríki	NOUN
koríkinin títa	koríkinin títa	NOUN
koróro	koróro	NOUN
korós	korós	NOUN
koshkínti	koshkínti	VERB[T]
koshkíti	koshkíti	VERB[I]
koshpámparo	koshpámparo	NOUN
koshpán	koshpán	NOUN
koshín	koshín	ADV
koshónti	koshónti	VERB[T]
koshóshka	koshóshka	NOUN
koskéti	koskéti	VERB[I]
kosés	kosés	ADJ
kotón	kotón	NOUN
koxkóxtobi	koxkóxtobi	NOUN
koxtéti	koxtéti	VERB[I]
koxéti	koxéti	VERB[T]
koxónewa	koxónewa	NOUN
koxónshewa	koxónshewa	NOUN
koyénke	koyénke	NOUN
koyósh	koyósh	ADJ
koánacha	koánacha	NOUN
koáratia	koáratia	NOUN
koásti	koásti	VERB[T]
koáti	koáti	VERB[T]
koéti	koéti	VERB[T]
koín	koín	NOUN
koínbires	koínbires	ADJ
koínkoin	koínkoin	NOUN
koínti	koínti	VERB[I]
koíranti	koíranti	VERB[T]
koíshiti	koíshiti	VERB[I]
koíshti	koíshti	VERB[T]
kpekexeeti	kpekexeeti	VERB[I]
kábirata	kábirata	NOUN
kábo	kábo	NOUN
káchiana	káchiana	ADJ
káchianti	káchianti	VERB[T]
káchibanti	káchibanti	VERB[T]
káchio	káchio	ADV
káchoti	káchoti	VERB[I]
kái ati	kái ati	VERB[T]
kája	kája	NOUN
kákaati	kákaati	VERB[T]
káki	káki	NOUN
kámaronka	kámaronka	NOUN
kámaronti	kámaronti	NOUN
kámpa	kámpa	NOUN
kámpianti	kámpianti	VERB[T]
kámpo	kámpo	NOUN
kána	kána	NOUN
kánachiari	kánachiari	NOUN
kánain	kánain	NOUN
kánaoon	kánaoon	NOUN
kánapo	kánapo	NOUN
kánchis	kánchis	ADJ
kánchoti	kánchoti	VERB[I]
kánkaati	kánkaati	VERB[T]
káno	káno	NOUN
kánsa	kánsa	NOUN
kánso	kánso	NOUN
káo	káo	NOUN
káocho	káocho	NOUN
káochohepon	káochohepon	NOUN
kápa	kápa	NOUN
kápajobo$bko	kápajobo$bko	NOUN
kápakkti	kápakkti	NOUN
kápapiti	kápapiti	NOUN
kápeten axa	kápeten axa	NOUN
kápitan	kápitan	NOUN
kápokaati	kápokaati	VERB[I]
káposoro	káposoro	NOUN
kápoti	kápoti	VERB[T]
kára	kára	ADJ
kára.	kára.	NOUN
káraboso	káraboso	NOUN
káraniro	káraniro	NOUN
káranirobake	káranirobake	NOUN
káranirobichi	káranirobichi	NOUN
kárapintiro	kárapintiro	NOUN
kárapita	kárapita	NOUN
kárasira	kárasira	NOUN
kárata	kárata	NOUN
kári	kári	NOUN
káritira	káritira	NOUN
káro	káro	NOUN
károati	károati	VERB[T]
károtae	károtae	NOUN
káshi	káshi	NOUN
káshibo	káshibo	NOUN
káshkakashka ati	káshkakashka ati	VERB[T]
kásho	kásho	NOUN
kásiosa	kásiosa	NOUN
kásoati	kásoati	VERB[T]
kásoti	kásoti	VERB[T]
kástichano	kástichano	NOUN
káta	káta	NOUN
kátaati	kátaati	VERB[T]
kátati	kátati	VERB[I]
kátaxameeti	kátaxameeti	VERB[I]
kátaxomeeti	kátaxomeeti	VERB[I]
káte	káte	NOUN
káteti	káteti	VERB[T]
káti	káti	VERB[I]
kátokaati	kátokaati	VERB[I]
kátoti	kátoti	VERB[T]
káwa	káwa	NOUN
káwati	káwati	VERB[T]
káxa	káxa	ADJ
káxati	káxati	VERB[I]
káxke	káxke	NOUN
káxketi	káxketi	VERB[T]
káxkiti	káxkiti	VERB[T]
káxni	káxni	NOUN
káxo	káxo	NOUN
káxo xao	káxo xao	NOUN
káxopa	káxopa	NOUN
káxteti	káxteti	VERB[T]
káya	káya	ADJ
káya	káya	NOUN
káyanenke	káyanenke	NOUN
káyatsawi	káyatsawi	NOUN
káyatseka	káyatseka	NOUN
kébiiti	kébiiti	VERB[I]
kébisasa	kébisasa	NOUN
kébo	kébo	NOUN
kéborox	kéborox	NOUN
kéchiti	kéchiti	VERB[I]
kéchokiiti	kéchokiiti	VERB[I]
kéen	kéen	NOUN
kéenti	kéenti	VERB[I]
kéeti	kéeti	NOUN
kéeti	kéeti	VERB[T]
kékoti	kékoti	VERB[T]
kémpo	kémpo	NOUN
kéna	kéna	NOUN
kénati	kénati	VERB[T]
kéne	kéne	NOUN
kéneti	kéneti	VERB[T]
kéni	kéni	NOUN
kénibiti	kénibiti	NOUN
kénikeni	kénikeni	ADJ
kénioma	kénioma	NOUN
kénoti	kénoti	VERB[T]
kénshi	kénshi	NOUN
kénshiti	kénshiti	VERB[I]
kénsho	kénsho	ADJ
kénshoti	kénshoti	NOUN
kénshoti	kénshoti	VERB[T]
kénto	kénto	ADJ
képekeeti	képekeeti	VERB[I]
képemeeti	képemeeti	VERB[I]
képenti	képenti	VERB[T]
képeti	képeti	VERB[I]
képoti	képoti	VERB[I]
késha	késha	NOUN
késhati	késhati	VERB[I]
késhka	késhka	ADJ
késhpa	késhpa	ADJ
késoti	késoti	VERB[T]
késtati	késtati	VERB[T]
késto	késto	ADJ
kéweti	kéweti	VERB[T]
kéxeti	kéxeti	VERB[T]
kéxkeati	kéxkeati	VERB[T]
kéxketi	kéxketi	VERB[I]
kéxme	kéxme	ADJ
kéxmi	kéxmi	ADJ
kéxmiati	kéxmiati	VERB[T]
kéxmiti	kéxmiti	VERB[I]
kéxpe	kéxpe	ADJ
kéxteti	kéxteti	VERB[T]
kéyoti	kéyoti	ADV
kéyoti	kéyoti	VERB[T]
kícho	kícho	ADJ
kíisti	kíisti	VERB[T]
kíkini	kíkini	ADV
kímisha	kímisha	ADJ
kímishai	kímishai	ADV
kína	kína	NOUN
kíni	kíni	NOUN
kíniati	kíniati	VERB[T]
kínto	kínto	ADJ
kírika	kírika	NOUN
kíro	kíro	NOUN
kírokaramo	kírokaramo	NOUN
kírosin	kírosin	NOUN
kíshi	kíshi	NOUN
kíshioma	kíshioma	ADJ
kíshioma	kíshioma	NOUN
kíshpina	kíshpina	ADJ
kískiti	kískiti	VERB[T]
kísoti	kísoti	VERB[T]
kíspo	kíspo	ADJ
kístati	kístati	VERB[T]
kísto	kísto	ADJ
kítamoro	kítamoro	NOUN
kítamoron iti	kítamoron iti	VERB[I]
kíxme	kíxme	ADJ
kíxni	kíxni	NOUN
kíxteti	kíxteti	VERB[T]
kóarino	kóarino	NOUN
kóbi	kóbi	NOUN
kóboranti	kóboranti	VERB[T]
kóchi	kóchi	NOUN
kóe	kóe	ADJ
kóeti	kóeti	VERB[I]
kói	kói	NOUN
kóikoiro	kóikoiro	NOUN
kóitatas	kóitatas	NOUN
kóka	kóka	NOUN
kóko	kóko	NOUN
kókoti	kókoti	VERB[T]
kóma	kóma	NOUN
kómatsewe	kómatsewe	NOUN
kómokomo	kómokomo	NOUN
kómpa	kómpa	NOUN
kómpanyiro	kómpanyiro	NOUN
kónawe	kónawe	NOUN
kóncho	kóncho	NOUN
kóni	kóni	NOUN
kónibo	kónibo	NOUN
kóno	kóno	NOUN
kónxamanchai	kónxamanchai	NOUN
kóo	kóo	NOUN
kóojison	kóojison	NOUN
kóoti	kóoti	VERB[I]
kópeke	kópeke	NOUN
kópikin	kópikin	VERB[PP1]
kópiti	kópiti	VERB[T]
kóri	kóri	NOUN
kóri inka	kóri inka	NOUN
kóriapiri	kóriapiri	NOUN
kórimachapa	kórimachapa	NOUN
kóro	kóro	ADJ
kóro	kóro	NOUN
kóroati	kóroati	VERB[T]
kórocha	kórocha	NOUN
kórokoro	kórokoro	NOUN
kóronita	kóronita	NOUN
kóropo	kóropo	NOUN
kóroti	kóroti	VERB[I]
kóshi	kóshi	ADJ
kóshi	kóshi	NOUN
kóshiati	kóshiati	VERB[T]
kóshiti	kóshiti	VERB[I]
kósho	kósho	NOUN
kóshomeeti	kóshomeeti	VERB[I]
kóshori	kóshori	NOUN
kóshorinin matsóti	kóshorinin matsóti	NOUN
kósi	kósi	NOUN
kósinira	kósinira	NOUN
kósketi	kósketi	VERB[T]
kóskiti	kóskiti	VERB[T]
kóta	kóta	NOUN
kóxba	kóxba	ADJ
kóxkochi	kóxkochi	NOUN
kóxkoraniti	kóxkoraniti	VERB[I]
kóxni	kóxni	NOUN
kóxo	kóxo	NOUN
kóxopeox	kóxopeox	NOUN
kóxteti	kóxteti	VERB[T]
kóyaparo	kóyaparo	NOUN
kóyo	kóyo	NOUN
kóyobocho	kóyobocho	NOUN
lnria	lnria	NOUN
lnria 	lnria 	NOUN
ma	ma	NOUN
mabán	mabán	NOUN
mabánti	mabánti	VERB[T]
mabénti	mabénti	VERB[T]
mabésti	mabésti	VERB[T]
mabéti	mabéti	VERB[T]
mabéx	mabéx	ADJ
mabíti	mabíti	VERB[T]
mabócho	mabócho	NOUN
mabón	mabón	ADJ
macháncati	macháncati	NOUN
machánkati	machánkati	NOUN
macháxti	macháxti	VERB[T]
machíto	machíto	NOUN
machóshti	machóshti	VERB[T]
macán	macán	NOUN
macánbeshe	macánbeshe	NOUN
macásh	macásh	NOUN
macón	macón	NOUN
macóncho	macóncho	NOUN
macósh	macósh	ADJ
mahuá	mahuá	ADJ
mahuá	mahuá	NOUN
mahuán	mahuán	NOUN
mahuásti	mahuásti	VERB[T]
mahuáti	mahuáti	VERB[I]
mahuécho	mahuécho	NOUN
mahuéti	mahuéti	VERB[T]
mahuínti	mahuínti	VERB[T]
mahuís	mahuís	NOUN
main	main	ADV
main 	main 	ADV
makán	makán	NOUN
makánbeshe	makánbeshe	NOUN
makásh	makásh	NOUN
makénti	makénti	VERB[T]
makéntita	makéntita	NOUN
makéxti	makéxti	VERB[T]
makín	makín	NOUN
makón	makón	NOUN
makóncho	makóncho	NOUN
makósh	makósh	ADJ
mampínhati	mampínhati	VERB[T]
mampínhati 	mampínhati 	VERB[T]
mampís	mampís	ADJ
mamánchi	mamánchi	NOUN
mamánti	mamánti	VERB[T]
mamí	mamí	NOUN
mamí 	mamí 	NOUN
mamósti	mamósti	VERB[T]
manaon	manaon	ADV
manaon	manaon	POSTP
manchán	manchán	NOUN
manchán 	manchán 	NOUN
manchéx	manchéx	NOUN
manchón	manchón	NOUN
manshín	manshín	NOUN
mansán	mansán	NOUN
manxán	manxán	ADJ
manxán	manxán	NOUN
manxánhati	manxánhati	VERB[T]
manxánteo	manxánteo	NOUN
manxánti	manxánti	VERB[I]
manxánto	manxánto	NOUN
manxóbina	manxóbina	NOUN
manxóbina 	manxóbina 	NOUN
manámaxca	manámaxca	NOUN
manámaxka	manámaxka	NOUN
manán	manán	NOUN
manáncahuishpo	manáncahuishpo	NOUN
manánkawishpo	manánkawishpo	NOUN
manántenaman	manántenaman	ADV
manánxahue	manánxahue	NOUN
manánxahuechibero	manánxahuechibero	NOUN
manánxahuejihui	manánxahuejihui	NOUN
manánxahuen tápiti	manánxahuen tápiti	NOUN
manánxawe	manánxawe	NOUN
manánxawechibero	manánxawechibero	NOUN
manánxawejiwi	manánxawejiwi	NOUN
manánxawen tápiti	manánxawen tápiti	NOUN
manáti	manáti	VERB[I]
manénti	manénti	VERB[I]
manéxti	manéxti	VERB[T]
manísh	manísh	ADJ
manísh	manísh	NOUN
manísh níiya	manísh níiya	NOUN
maníshti	maníshti	VERB[I]
maníti	maníti	VERB[I]
manóti	manóti	VERB[I]
mapáchi	mapáchi	NOUN
mapáchi 	mapáchi 	NOUN
mapánti	mapánti	VERB[T]
mapásti	mapásti	VERB[T]
mapénti	mapénti	VERB[T]
mapéti	mapéti	VERB[I]
mapéxti	mapéxti	VERB[I]
mapó	mapó	NOUN
mapó kesikonti	mapó kesikonti	VERB[T]
mapó quesiconti	mapó quesiconti	VERB[T]
mapóchekere	mapóchekere	NOUN
mapóchequere	mapóchequere	NOUN
mapókeresati	mapókeresati	VERB[T]
mapóqueresati	mapóqueresati	VERB[T]
mapósa	mapósa	NOUN
mapóti	mapóti	NOUN
mapóti	mapóti	VERB[I]
maquénti	maquénti	VERB[T]
maquéntita	maquéntita	NOUN
maquéxti	maquéxti	VERB[T]
maquín	maquín	NOUN
maránya	maránya	NOUN
maráx	maráx	NOUN
marénti	marénti	VERB[T]
maréti	maréti	VERB[T]
maría	maría	NOUN
maríntanhis	maríntanhis	NOUN
maríntanhis 	maríntanhis 	NOUN
maríshkiti	maríshkiti	VERB[T]
maríshquiti	maríshquiti	VERB[T]
maríta	maríta	NOUN
mashmón	mashmón	ADJ
mashpá	mashpá	NOUN
mashpán	mashpán	NOUN
mashtínti	mashtínti	VERB[T]
masháica	masháica	NOUN
masháika	masháika	NOUN
masháiti	masháiti	VERB[I]
mashínshi	mashínshi	NOUN
mashínshi 	mashínshi 	NOUN
mashínshin	mashínshin	NOUN
mashíntari	mashíntari	NOUN
mashínti	mashínti	NOUN
mashínti 	mashínti 	NOUN
masmó	masmó	ADJ
maspó	maspó	NOUN
masáati	masáati	VERB[T]
masábires téneti	masábires téneti	NOUN
masámabires	masámabires	ADJ
masáti	masáti	VERB[I]
masén	masén	NOUN
masés	masés	ADJ
masóiti	masóiti	VERB[I]
maton	maton	ADJ
matsínti	matsínti	VERB[T]
matsónti	matsónti	VERB[T]
matsósti	matsósti	VERB[T]
matsóti	matsóti	NOUN
matsóti	matsóti	VERB[T]
matánti	matánti	VERB[T]
matásti	matásti	VERB[T]
matáti	matáti	VERB[I]
matáx	matáx	NOUN
matáxnanti	matáxnanti	VERB[T]
matáxnati	matáxnati	VERB[T]
mató	mató	NOUN
matósh	matósh	NOUN
matóshti	matóshti	VERB[T]
matóti	matóti	VERB[T]
mawá	mawá	ADJ
mawá	mawá	NOUN
mawán	mawán	NOUN
mawásti	mawásti	VERB[T]
mawáti	mawáti	VERB[I]
mawécho	mawécho	NOUN
mawéti	mawéti	VERB[T]
mawínti	mawínti	VERB[T]
mawís	mawís	NOUN
maxbáti	maxbáti	VERB[T]
maxcáti	maxcáti	VERB[I]
maxkáti	maxkáti	VERB[I]
maxkíiti	maxkíiti	VERB[I]
maxpó	maxpó	ADJ
maxquíiti	maxquíiti	VERB[I]
maxtán	maxtán	ADJ
maxáx	maxáx	NOUN
maxáxti	maxáxti	VERB[T]
maxéti	maxéti	VERB[T]
maxó	maxó	NOUN
maxóniti	maxóniti	VERB[I]
maxótsatsa	maxótsatsa	NOUN
mayá	mayá	NOUN
mayáti	mayáti	VERB[I]
mayén	mayén	ADJ
mayósh	mayósh	ADJ
mayóti	mayóti	VERB[T]
maín	maín	NOUN
maís	maís	ADJ
maístara	maístara	NOUN
maístara 	maístara 	NOUN
maístoro	maístoro	NOUN
maístoro 	maístoro 	NOUN
maíti	maíti	VERB[I]
maóx	maóx	ADJ
mebénti	mebénti	VERB[T]
mebís	mebís	ADJ
mebískiiti	mebískiiti	VERB[I]
mebísquiiti	mebísquiiti	VERB[I]
mechá	mechá	ADJ
mecháma	mecháma	ADJ
mecháshti	mecháshti	VERB[T]
mecháti	mecháti	VERB[I]
mechéxti	mechéxti	VERB[I]
mechéxti	mechéxti	VERB[T]
mechóti	mechóti	VERB[T]
mecósh	mecósh	ADJ
mehuáti	mehuáti	VERB[T]
mehuéxti	mehuéxti	VERB[T]
mehuíshti	mehuíshti	VERB[T]
mekémapo	mekémapo	NOUN
mekémebi	mekémebi	NOUN
mekémpeka	mekémpeka	NOUN
mekén	mekén	NOUN
mekénapax	mekénapax	NOUN
mekénchinita	mekénchinita	NOUN
mekéntechapa	mekéntechapa	NOUN
mekéntonko	mekéntonko	NOUN
mekéti	mekéti	VERB[I]
mekéxti	mekéxti	VERB[T]
mekósh	mekósh	ADJ
meménooti	meménooti	VERB[I]
memóshti	memóshti	VERB[T]
memósti	memósti	VERB[T]
men	men	ADV
menchán	menchán	NOUN
mencó	mencó	ADJ
mencómati	mencómati	VERB[T]
mencónti	mencónti	VERB[T]
menkó	menkó	ADJ
menkómati	menkómati	VERB[T]
menkónti	menkónti	VERB[T]
mensán	mensán	ADJ
mentsís	mentsís	NOUN
menéxti	menéxti	VERB[T]
menín	menín	ADJ
menínhati	menínhati	VERB[T]
menínti	menínti	VERB[I]
meníti	meníti	VERB[I]
menó	menó	ADJ
menó	menó	NOUN
menóti	menóti	VERB[I]
mepásti	mepásti	VERB[T]
mepíshti	mepíshti	VERB[T]
mepón	mepón	NOUN
mepóti	mepóti	VERB[I]
mepóti	mepóti	VERB[T]
mequémapo 	mequémapo 	NOUN
mequémebi	mequémebi	NOUN
mequémpeca	mequémpeca	NOUN
mequén	mequén	NOUN
mequénapax	mequénapax	NOUN
mequénchinita	mequénchinita	NOUN
mequéntechapa	mequéntechapa	NOUN
mequéntonco	mequéntonco	NOUN
mequéti	mequéti	VERB[I]
mequéxti	mequéxti	VERB[T]
meran	meran	POSTP
meráti	meráti	VERB[I]
meráya	meráya	NOUN
mescó	mescó	ADJ
mescóti	mescóti	VERB[T]
meshcánti	meshcánti	VERB[T]
meshcáti	meshcáti	VERB[I]
meshkánti	meshkánti	VERB[T]
meshkáti	meshkáti	VERB[I]
meshmón	meshmón	ADJ
meshmón 	meshmón 	ADJ
meshtínti	meshtínti	VERB[T]
meshóati	meshóati	VERB[T]
meshóti	meshóti	VERB[I]
meské	meské	NOUN
meskíti	meskíti	VERB[I]
meskó	meskó	ADJ
meskóti	meskóti	VERB[T]
mespóti	mespóti	VERB[I]
mesqué	mesqué	NOUN
mesquíti	mesquíti	VERB[I]
mesénbinati	mesénbinati	VERB[I]
mesés	mesés	ADJ
mesó	mesó	NOUN
metsá	metsá	ADJ
metsáshoco	metsáshoco	ADJ
metsáshoko	metsáshoko	ADJ
metséti	metséti	VERB[T]
metsínti	metsínti	VERB[I]
metsísti	metsísti	VERB[I]
metsíti	metsíti	VERB[T]
metáxnameeti	metáxnameeti	VERB[I]
metéxti	metéxti	VERB[T]
metóshti	metóshti	VERB[T]
metósti	metósti	VERB[T]
metóti	metóti	VERB[T]
mewáti	mewáti	VERB[T]
mewéxti	mewéxti	VERB[T]
mewíshti	mewíshti	VERB[T]
mexté	mexté	NOUN
mextéti	mextéti	VERB[I]
mexéti	mexéti	VERB[I]
mexóti	mexóti	VERB[T]
meyá	meyá	ADJ
meyán	meyán	ADJ
meyén	meyén	ADJ
meyósh	meyósh	ADJ
meyóti	meyóti	VERB[T]
meánhati	meánhati	VERB[T]
meánti	meánti	VERB[I]
meíkiti	meíkiti	VERB[I]
meínti	meínti	VERB[T]
meíquiti	meíquiti	VERB[I]
meísti	meísti	VERB[T]
meíti	meíti	VERB[T]
meósoti	meósoti	NOUN
mia	mia	PRON
micánico	micánico	NOUN
micárahua	micárahua	NOUN
mikániko	mikániko	NOUN
mikárawa	mikárawa	NOUN
mikíri	mikíri	NOUN
min	min	ADJ
mintómati	mintómati	VERB[T]
mintón	mintón	NOUN
mintónhati	mintónhati	VERB[T]
mintónti	mintónti	VERB[I]
minóto	minóto	NOUN
minóto acai	minóto acai	NOUN
minóto akai	minóto akai	NOUN
miquíri	miquíri	NOUN
mirión	mirión	NOUN
mirión 	mirión 	NOUN
miríco 	miríco 	NOUN
mirícoti	mirícoti	NOUN
miríko	miríko	NOUN
miríkoti	miríkoti	NOUN
miríntires	miríntires	NOUN
mirón	mirón	NOUN
mis	mis	ADV
miscóisin	miscóisin	NOUN
mishkíti	mishkíti	VERB[I]
mishquíti	mishquíti	VERB[I]
mishíto	mishíto	NOUN
mishíto 	mishíto 	NOUN
misión	misión	NOUN
miskóisin	miskóisin	NOUN
mispán	mispán	NOUN
mispánti	mispánti	VERB[T]
mitán	mitán	NOUN
mitó	mitó	NOUN
mitóti	mitóti	VERB[I]
mixé	mixé	NOUN
moa	moa	ADV
montária	montária	NOUN
montária 	montária 	NOUN
montáti	montáti	VERB[T]
montáti 	montáti 	VERB[T]
montíti	montíti	NOUN
montíti 	montíti 	NOUN
moníca	moníca	NOUN
moníka	moníka	NOUN
moníti	moníti	VERB[I]
morínchopa	morínchopa	NOUN
moshí	moshí	ADJ
moshíti	moshíti	VERB[I]
motsíti	motsíti	VERB[I]
motóro	motóro	NOUN
moxó	moxó	NOUN
moábo	moábo	NOUN
moácha	moácha	ADV
moátian	moátian	ADV
moátian joi	moátian joi	NOUN
moáxeni	moáxeni	ADJ
moénti	moénti	VERB[T]
moíshati	moíshati	VERB[T]
moíshiti	moíshiti	VERB[I]
máan iti	máan iti	VERB[I]
máanhati	máanhati	VERB[T]
máanti	máanti	VERB[I]
mábichi	mábichi	NOUN
mábikiiti	mábikiiti	VERB[I]
mábiquiiti	mábiquiiti	VERB[I]
máca	máca	NOUN
mácachipon	mácachipon	NOUN
mácho	mácho	ADJ
máchoshiiti	máchoshiiti	VERB[I]
máeati	máeati	VERB[T]
máecahua	máecahua	NOUN
máekawa	máekawa	NOUN
máeri	máeri	NOUN
máeri 	máeri 	NOUN
máeti	máeti	VERB[I]
máhuati	máhuati	VERB[T]
máhuetan	máhuetan	NOUN
máhueti	máhueti	NOUN
máhueti	máhueti	VERB[T]
mái	mái	NOUN
mái mapoti	mái mapoti	NOUN
máiti	máiti	NOUN
máiti	máiti	VERB[T]
máka	máka	NOUN
mákachipon	mákachipon	NOUN
máke	máke	NOUN
máki	máki	NOUN
mákina	mákina	NOUN
mákiri	mákiri	NOUN
mámepasti	mámepasti	VERB[T]
mámpa	mámpa	ADJ
mámpai	mámpai	NOUN
mámpi	mámpi	NOUN
mámpi 	mámpi 	NOUN
mánaiti	mánaiti	VERB[I]
mánapo	mánapo	NOUN
mánati	mánati	VERB[T]
mánco	mánco	NOUN
máncoa	máncoa	NOUN
máncomaxe	máncomaxe	NOUN
máncoti	máncoti	VERB[T]
máneti	máneti	VERB[T]
máni	máni	NOUN
mánipei	mánipei	NOUN
mánko	mánko	NOUN
mánkoa	mánkoa	NOUN
mánkomaxe	mánkomaxe	NOUN
mánkoti	mánkoti	VERB[T]
máno	máno	NOUN
mánocoxoti	mánocoxoti	VERB[I]
mánokoxoti	mánokoxoti	VERB[I]
mánonoco	mánonoco	NOUN
mánonoko	mánonoko	NOUN
mánoti	mánoti	VERB[T]
mánxaman cahuáti	mánxaman cahuáti	NOUN
mánxaman ehua	mánxaman ehua	NOUN
mánxaman ewa	mánxaman ewa	NOUN
mánxaman kawáti	mánxaman kawáti	NOUN
máo	máo	NOUN
mápa	mápa	NOUN
mápekeeti	mápekeeti	VERB[I]
mápemeeti	mápemeeti	VERB[I]
mápemeeti 	mápemeeti 	VERB[I]
mápequeeti	mápequeeti	VERB[I]
mápi	mápi	NOUN
mápishiiti	mápishiiti	VERB[I]
mápo	mápo	NOUN
mápocan téetai	mápocan téetai	NOUN
mápokan téetai	mápokan téetai	NOUN
mápoti	mápoti	VERB[T]
mápoxao	mápoxao	NOUN
mápoyenken	mápoyenken	ADJ
mápoyenquen	mápoyenquen	ADJ
máque	máque	NOUN
máqui	máqui	NOUN
máquina	máquina	NOUN
máquiri	máquiri	NOUN
mára	mára	NOUN
máraca 	máraca 	NOUN
máracanti	máracanti	NOUN
márachanti	márachanti	VERB[I]
máraka	máraka	NOUN
márakanti	márakanti	NOUN
máraticho	máraticho	NOUN
mári	mári	NOUN
máriniro	máriniro	NOUN
máriniro 	máriniro 	NOUN
máromati	máromati	VERB[T]
mároti	mároti	VERB[I]
máshcati	máshcati	VERB[T]
máshi	máshi	NOUN
máshimaxca	máshimaxca	NOUN
máshimaxka	máshimaxka	NOUN
máshkati	máshkati	VERB[T]
másho	másho	NOUN
máshpi	máshpi	NOUN
mási	mási	NOUN
máspa	máspa	ADJ
mátapo	mátapo	NOUN
mátataon	mátataon	NOUN
mátati	mátati	VERB[T]
máto	máto	PRON
mátsacaati	mátsacaati	VERB[I]
mátsakaati	mátsakaati	VERB[I]
mátsi	mátsi	NOUN
mátsocasti	mátsocasti	VERB[I]
mátsokasti	mátsokasti	VERB[I]
mátsoti	mátsoti	VERB[I]
máwati	máwati	VERB[T]
máwetan	máwetan	NOUN
máweti	máweti	NOUN
máweti	máweti	VERB[T]
máxaxacati	máxaxacati	VERB[I]
máxaxakati	máxaxakati	VERB[I]
máxco	máxco	ADJ
máxcorooti	máxcorooti	VERB[I]
máxcoroti	máxcoroti	VERB[T]
máxcoroya	máxcoroya	ADJ
máxcoshoco cochára	máxcoshoco cochára	NOUN
máxe	máxe	NOUN
máxechachi	máxechachi	NOUN
máxko	máxko	ADJ
máxkorooti	máxkorooti	VERB[I]
máxkoroti	máxkoroti	VERB[T]
máxkoroya	máxkoroya	ADJ
máxkoshoko kochára	máxkoshoko kochára	NOUN
máxopo	máxopo	NOUN
máyacati	máyacati	VERB[I]
máyakati	máyakati	VERB[I]
máyati	máyati	VERB[T]
máyo	máyo	NOUN
máyo 	máyo 	NOUN
méa	méa	NOUN
mébi	mébi	NOUN
mébichinti	mébichinti	VERB[T]
mécayao	mécayao	ADV
mécayao	mécayao	POSTP
mécha	mécha	ADJ
méchaati	méchaati	VERB[I]
méchati	méchati	VERB[T]
méchiti	méchiti	VERB[I]
mécho	mécho	ADJ
méchokiiti	méchokiiti	VERB[I]
méchoquiiti	méchoquiiti	VERB[I]
méchoti	méchoti	VERB[I]
méecaati	méecaati	VERB[I]
méekaati	méekaati	VERB[I]
méeti	méeti	VERB[T]
méhue	méhue	NOUN
méhueti	méhueti	VERB[T]
méhuexeeti	méhuexeeti	VERB[I]
méi	méi	NOUN
mékayao	mékayao	ADV
mékayao	mékayao	POSTP
méketi	méketi	VERB[T]
mékexeeya	mékexeeya	NOUN
mémi	mémi	NOUN
mémio	mémio	ADV
mémio	mémio	POSTP
ménatexmeeti	ménatexmeeti	VERB[I]
ménatexti	ménatexti	VERB[T]
méncóti	méncóti	VERB[I]
ménexeeti	ménexeeti	NOUN
ménexeeti	ménexeeti	VERB[I]
ménexeeti 	ménexeeti 	NOUN
ménicaati	ménicaati	VERB[I]
ménikaati	ménikaati	VERB[I]
méniti	méniti	VERB[T]
ménkóti	ménkóti	VERB[I]
ménoti	ménoti	VERB[T]
ménto	ménto	ADJ
mépiti	mépiti	VERB[I]
mépoti	mépoti	VERB[T]
méqueti	méqueti	VERB[T]
méquexeeya 	méquexeeya 	NOUN
méramaati	méramaati	VERB[I]
mérati	mérati	NOUN
mérati	mérati	VERB[T]
méscoti	méscoti	VERB[T]
méshaconti	méshaconti	VERB[T]
méshakonti	méshakonti	VERB[T]
méshcao	méshcao	ADV
méshcao	méshcao	POSTP
méshi	méshi	ADJ
méshi	méshi	NOUN
méshipapi	méshipapi	NOUN
méshkao	méshkao	ADV
méshkao	méshkao	POSTP
méskiti	méskiti	VERB[T]
méskoti	méskoti	VERB[T]
méspa	méspa	ADJ
méspo	méspo	ADJ
mésquiti	mésquiti	VERB[T]
méstati	méstati	VERB[T]
mésti	mésti	ADJ
mésti	mésti	NOUN
méstiti	méstiti	VERB[I]
mésto	mésto	ADJ
métaacati	métaacati	VERB[I]
métaakati	métaakati	VERB[I]
métaneti	métaneti	VERB[T]
métati	métati	VERB[T]
méteki	méteki	NOUN
métequi	métequi	NOUN
métexeeti	métexeeti	VERB[I]
métininti	métininti	VERB[I]
métocaati	métocaati	VERB[I]
métokaati	métokaati	VERB[I]
métoti	métoti	NOUN
métoti	métoti	VERB[T]
méwe	méwe	NOUN
méweti	méweti	VERB[T]
méwexeeti	méwexeeti	VERB[I]
méxati	méxati	VERB[T]
méxba	méxba	ADJ
méxca	méxca	ADJ
méxka	méxka	ADJ
méxni	méxni	NOUN
méxocooti	méxocooti	VERB[I]
méxokooti	méxokooti	VERB[I]
méxoti	méxoti	VERB[I]
méxteti	méxteti	VERB[T]
mícati	mícati	VERB[T]
mícha	mícha	NOUN
míchoti	míchoti	VERB[T]
míimeeti	míimeeti	VERB[I]
míinti	míinti	VERB[T]
míjico 	míjico 	NOUN
míjiko	míjiko	NOUN
míkati	míkati	VERB[T]
mínca	mínca	NOUN
mínka	mínka	NOUN
míno	míno	ADJ
mínta	mínta	NOUN
mínta 	mínta 	NOUN
míriaora	míriaora	NOUN
míricato 	míricato 	NOUN
mírikato	mírikato	NOUN
mírio	mírio	ADJ
mírio 	mírio 	ADJ
mísa	mísa	NOUN
mísco	mísco	ADJ
míscoti	míscoti	VERB[I]
míshkiti	míshkiti	NOUN
míshkiti	míshkiti	VERB[T]
míshkín	míshkín	NOUN
míshquiti	míshquiti	NOUN
míshquiti	míshquiti	VERB[T]
míshquín	míshquín	NOUN
mísi	mísi	NOUN
mísiati	mísiati	VERB[T]
mísibehue	mísibehue	NOUN
mísibewe	mísibewe	NOUN
mísioniro	mísioniro	NOUN
mísko	mísko	ADJ
mískoti	mískoti	VERB[I]
mísmiri	mísmiri	NOUN
mítoro	mítoro	NOUN
mítoro 	mítoro 	NOUN
míxeti	míxeti	VERB[T]
móca	móca	ADJ
móca	móca	NOUN
mócaati	mócaati	VERB[T]
mócabimi	mócabimi	NOUN
mócapari	mócapari	NOUN
mócati	mócati	VERB[I]
móchati	móchati	VERB[I]
mócho	mócho	NOUN
mócoti	mócoti	VERB[T]
móe	móe	NOUN
móka	móka	ADJ
móka	móka	NOUN
mókaati	mókaati	VERB[T]
mókabimi	mókabimi	NOUN
mókapari	mókapari	NOUN
mókati	mókati	VERB[I]
mókoti	mókoti	VERB[T]
mómo	mómo	NOUN
mónati	mónati	VERB[T]
mónso	mónso	NOUN
móo	móo	NOUN
móra	móra	NOUN
móro	móro	NOUN
móromashaiti	móromashaiti	VERB[I]
móroteo	móroteo	NOUN
mórotipiricanti 	mórotipiricanti 	VERB[T]
mórotipiricasion 	mórotipiricasion 	NOUN
mórotipirikanti	mórotipirikanti	VERB[T]
mórotipirikasion	mórotipirikasion	NOUN
móroxehua	móroxehua	NOUN
móroxewa	móroxewa	NOUN
móshati	móshati	VERB[T]
móshi	móshi	ADJ
móshiati	móshiati	VERB[T]
móshiti	móshiti	VERB[I]
móti	móti	NOUN
móto	móto	NOUN
mótsati	mótsati	VERB[T]
mótsiti	mótsiti	VERB[T]
móxa	móxa	NOUN
móxati	móxati	VERB[T]
móxiti	móxiti	VERB[I]
na	na	ADV
na	na	NOUN
nabáca	nabáca	NOUN
nabáka	nabáka	NOUN
nabéti	nabéti	VERB[T]
nabí	nabí	NOUN
nabíro	nabíro	NOUN
nabíroati	nabíroati	VERB[T]
nabón	nabón	NOUN
nachíti	nachíti	VERB[T]
nacáx	nacáx	NOUN
nacó	nacó	ADJ
nacómati	nacómati	VERB[T]
nacóti	nacóti	VERB[I]
nahuánbai	nahuánbai	NOUN
nahuáncocoti	nahuáncocoti	NOUN
nahuánjane	nahuánjane	NOUN
nahué 	nahué 	ADJ
nahué 	nahué 	NOUN
nakáx	nakáx	NOUN
nakó	nakó	ADJ
nakómati	nakómati	VERB[T]
nakóti	nakóti	VERB[I]
namá	namá	NOUN
namán	namán	ADV
namán	namán	POSTP
namánbires	namánbires	ADV
namáti	namáti	VERB[T]
nantáati	nantáati	VERB[T]
nantánti	nantánti	VERB[I]
nantáti	nantáti	VERB[I]
nanéti	nanéti	VERB[I]
napón	napón	ADV
napón	napón	POSTP
napónbecon	napónbecon	ADV
napónbecon	napónbecon	NOUN
napónbekon	napónbekon	ADV
napónbekon	napónbekon	NOUN
napónti	napónti	VERB[I]
napóti	napóti	VERB[T]
naránbekeeti	naránbekeeti	VERB[I]
naránbequeeti	naránbequeeti	VERB[I]
naránbeti	naránbeti	VERB[T]
naránxa	naránxa	NOUN
nashíti	nashíti	VERB[I]
naspán	naspán	NOUN
nasí	nasí	ADJ
nasí iti	nasí iti	VERB[I]
natsáti	natsáti	VERB[T]
natséti	natséti	VERB[T]
natsíscooti	natsíscooti	VERB[I]
natsíscoti	natsíscoti	VERB[T]
natsískooti	natsískooti	VERB[I]
natsískoti	natsískoti	VERB[T]
natánti	natánti	VERB[T]
natáxnacaati	natáxnacaati	VERB[I]
natáxnakaati	natáxnakaati	VERB[I]
natéx	natéx	ADJ
natéx	natéx	NOUN
natéxmis	natéxmis	ADJ
natéxti	natéxti	VERB[T]
natínti	natínti	VERB[I]
natínti 	natínti 	VERB[I]
nawánbai	nawánbai	NOUN
nawánjane	nawánjane	NOUN
nawánkokoti	nawánkokoti	NOUN
nawé	nawé	ADJ
nawé	nawé	NOUN
naxbá	naxbá	ADJ
naxbá	naxbá	NOUN
naxbáati	naxbáati	VERB[T]
naxbáti	naxbáti	VERB[I]
naxá	naxá	NOUN
naxáati	naxáati	VERB[T]
naxáati 	naxáati 	VERB[T]
naxánke	naxánke	NOUN
naxánque	naxánque	NOUN
nayáati	nayáati	VERB[T]
nayásanti	nayásanti	VERB[T]
nayáti	nayáti	VERB[I]
naí	naí	NOUN
naíkiti	naíkiti	VERB[I]
naín	naín	NOUN
naíquiti	naíquiti	VERB[I]
naísti	naísti	VERB[T]
naítsaca	naítsaca	NOUN
naítsaka	naítsaka	NOUN
nebíti	nebíti	VERB[T]
nemín	nemín	ADJ
nemínhati	nemínhati	VERB[T]
nemínti	nemínti	VERB[I]
nenké	nenké	ADJ
nenké	nenké	NOUN
nenkéati	nenkéati	VERB[T]
nenkéma	nenkéma	ADJ
nenkéti	nenkéti	VERB[I]
nenqué	nenqué	ADJ
nenqué	nenqué	NOUN
nenquéati	nenquéati	VERB[T]
nenquéma	nenquéma	ADJ
nenquéti	nenquéti	VERB[I]
nenánti	nenánti	VERB[T]
neníchinti	neníchinti	VERB[T]
nepá	nepá	NOUN
nepáx	nepáx	NOUN
nepóti	nepóti	VERB[T]
nerón	nerón	NOUN
nescáaquin	nescáaquin	ADV
neskáakin	neskáakin	ADV
nesé	nesé	ADJ
neténtsintsin	neténtsintsin	NOUN
netéshoco	netéshoco	ADJ
netéshoko	netéshoko	ADJ
netéti	netéti	VERB[I]
nexbá	nexbá	NOUN
nexnéx	nexnéx	NOUN
nexá	nexá	NOUN
nexá 	nexá 	NOUN
nexéti	nexéti	NOUN
neá	neá	NOUN
neíno	neíno	NOUN
neíno 	neíno 	NOUN
neínonin chái	neínonin chái	NOUN
nia	nia	POSTP
nibí	nibí	NOUN
nichínti	nichínti	VERB[T]
nihuán	nihuán	NOUN
nihuánti	nihuánti	VERB[I]
nihuén ehua	nihuén ehua	NOUN
nincáti	nincáti	VERB[T]
ninkáti	ninkáti	VERB[T]
ninóti	ninóti	VERB[I]
niscán	niscán	NOUN
niscán jóconai quínishoco	niscán jóconai quínishoco	NOUN
niscánti	niscánti	VERB[I]
nishbín	nishbín	NOUN
niskán	niskán	NOUN
niskán jókonai kínishoko	niskán jókonai kínishoko	NOUN
niskánti	niskánti	VERB[I]
nisá	nisá	NOUN
niwán	niwán	NOUN
niwánti	niwánti	VERB[I]
niwén ewa	niwén ewa	NOUN
noa	noa	PRON
nobé	nobé	NOUN
nobé 	nobé 	NOUN
nobéti	nobéti	VERB[T]
nobéti 	nobéti 	VERB[T]
nobéx	nobéx	NOUN
nobéx 	nobéx 	NOUN
nocon	nocon	ADJ
nocóti	nocóti	VERB[I]
nokon	nokon	ADJ
nokóti	nokóti	VERB[I]
non	non	ADJ
nontínbake	nontínbake	NOUN
nontínbaque	nontínbaque	NOUN
nonéxti	nonéxti	VERB[T]
nonó	nonó	NOUN
nonón	nonón	NOUN
nopéx	nopéx	NOUN
norex icai	norex icai	NOUN
norex ikai	norex ikai	NOUN
noréshpi	noréshpi	NOUN
noshí	noshí	ADJ
noshí	noshí	NOUN
noshíti	noshíti	VERB[I]
noshó	noshó	ADJ
noshó	noshó	NOUN
notsínti	notsínti	VERB[T]
noyá	noyá	NOUN
noín	noín	NOUN
noín raó	noín raó	NOUN
náa	náa	NOUN
náaapo	náaapo	NOUN
náabati	náabati	VERB[I]
náboman tsácati	náboman tsácati	NOUN
náboman tsákati	náboman tsákati	NOUN
náca	náca	NOUN
nácacaati	nácacaati	VERB[I]
nácati	nácati	VERB[T]
náchi	náchi	NOUN
náchi 	náchi 	NOUN
nácoti	nácoti	VERB[T]
náhua	náhua	NOUN
náhuaati	náhuaati	VERB[T]
náhuarinica	náhuarinica	NOUN
náhuashia	náhuashia	NOUN
náhuashian	náhuashian	NOUN
náhue	náhue	NOUN
náka	náka	NOUN
nákakaati	nákakaati	VERB[I]
nákati	nákati	VERB[T]
nákini	nákini	NOUN
nákoti	nákoti	VERB[T]
námi	námi	NOUN
náne	náne	NOUN
náneti	náneti	NOUN
náneti	náneti	VERB[T]
náno	náno	NOUN
nápaniti	nápaniti	VERB[I]
nápo	nápo	NOUN
nápocooti	nápocooti	VERB[I]
nápokooti	nápokooti	VERB[I]
nápomeameken	nápomeameken	NOUN
nápomeamequen	nápomeamequen	NOUN
náquini	náquini	NOUN
náracanti	náracanti	VERB[T]
náracati	náracati	VERB[I]
nárakanti	nárakanti	VERB[T]
nárakati	nárakati	VERB[I]
náshimati	náshimati	VERB[T]
náshiti	náshiti	VERB[I]
náshiti	náshiti	VERB[T]
nási	nási	NOUN
násimaxca	násimaxca	NOUN
násimaxka	násimaxka	NOUN
násoti	násoti	VERB[T]
nátacaati	nátacaati	VERB[I]
nátakaati	nátakaati	VERB[I]
nátapotl	nátapotl	NOUN
nátati	nátati	VERB[T]
nátexeeti	nátexeeti	VERB[I]
náto	náto	ADJ
náto	náto	PRON
náto 	náto 	ADJ
náto 	náto 	PRON
náwa	náwa	NOUN
náwaati	náwaati	VERB[T]
náwarinika	náwarinika	NOUN
náwashia	náwashia	NOUN
náwashian	náwashian	NOUN
náwe	náwe	NOUN
náxati	náxati	VERB[I]
náxpe	náxpe	ADJ
náxpeti	náxpeti	VERB[I]
náyacati	náyacati	VERB[I]
náyakati	náyakati	VERB[I]
néa	néa	NOUN
néati	néati	VERB[T]
née	née	NOUN
néeti	néeti	VERB[I]
néke	néke	ADV
néna	néna	NOUN
néne	néne	NOUN
néne 	néne 	NOUN
néneati	néneati	VERB[T]
néneti	néneti	VERB[I]
néno	néno	ADV
néque	néque	ADV
néracati	néracati	VERB[I]
nérakati	nérakati	VERB[I]
néri	néri	ADV
nésa	nésa	NOUN
néscatax	néscatax	ADV
néseti	néseti	VERB[I]
néskatax	néskatax	ADV
néte	néte	NOUN
néteti	néteti	VERB[I]
néxati	néxati	VERB[T]
níacaati	níacaati	VERB[I]
níakaati	níakaati	VERB[I]
níati	níati	VERB[T]
níbo	níbo	NOUN
níbo 	níbo 	NOUN
níbopotati	níbopotati	NOUN
níchimeeti	níchimeeti	VERB[I]
nícoro 	nícoro 	NOUN
níhue	níhue	NOUN
níhueaba	níhueaba	NOUN
níhueshaman	níhueshaman	NOUN
níi	níi	NOUN
níimaxo	níimaxo	NOUN
níkoro	níkoro	NOUN
níma	níma	NOUN
nínati	nínati	VERB[I]
nínbonish	nínbonish	NOUN
níshi	níshi	NOUN
níshiboanhis	níshiboanhis	NOUN
níshno	níshno	ADJ
níshnoririti	níshnoririti	VERB[I]
níshnoti	níshnoti	VERB[I]
níshobo	níshobo	NOUN
níshto	níshto	NOUN
níti	níti	VERB[I]
níticoma 	níticoma 	ADJ
níticomati	níticomati	VERB[I]
nítikoma	nítikoma	ADJ
nítikomati	nítikomati	VERB[I]
níwe	níwe	NOUN
níweaba	níweaba	NOUN
níweshaman	níweshaman	NOUN
nóati	nóati	VERB[T]
nócaati	nócaati	VERB[T]
nócati	nócati	VERB[I]
nócho	nócho	NOUN
nóchopoco	nóchopoco	NOUN
nóchopoko	nóchopoko	NOUN
nócoti	nócoti	VERB[I]
nóe	nóe	ADJ
nóeati	nóeati	VERB[T]
nóeti	nóeti	VERB[I]
nói	nói	NOUN
nóibati	nóibati	VERB[T]
nóibatishoco	nóibatishoco	ADJ
nóibatishoko	nóibatishoko	ADJ
nóimis	nóimis	ADJ
nóiti	nóiti	VERB[T]
nókaati	nókaati	VERB[T]
nókati	nókati	VERB[I]
nókoti	nókoti	VERB[I]
nóma	nóma	NOUN
nómi	nómi	NOUN
nómiro	nómiro	NOUN
nómiti	nómiti	VERB[I]
nónti	nónti	NOUN
nóntipoinki	nóntipoinki	NOUN
nóntipoinqui	nóntipoinqui	NOUN
nóoxiti	nóoxiti	VERB[I]
nóreti	nóreti	NOUN
nóreti	nóreti	VERB[T]
nóriti	nóriti	NOUN
nóriti 	nóriti 	NOUN
nóritisti	nóritisti	NOUN
nóritisti 	nóritisti 	NOUN
nósha	nósha	NOUN
nóshiti	nóshiti	VERB[T]
nótsiti	nótsiti	VERB[I]
nóxa	nóxa	NOUN
nóxati	nóxati	NOUN
nóxati	nóxati	VERB[T]
nóxati 	nóxati 	NOUN
nóxoti	nóxoti	VERB[T]
nóxteti	nóxteti	VERB[T]
nóxóti	nóxóti	VERB[T]
nóyati	nóyati	VERB[I]
o	o	NOUN
oa	oa	POSTP
obispo	obispo	NOUN
obán	obán	NOUN
obé	obé	NOUN
obíja	obíja	NOUN
obíja 	obíja 	NOUN
ochán ehua	ochán ehua	NOUN
ochán ewa	ochán ewa	NOUN
ochíti	ochíti	NOUN
ochó	ochó	ADV
ochóati	ochóati	VERB[T]
ochóma	ochóma	ADV
ochóti	ochóti	VERB[I]
ocánchoca	ocánchoca	NOUN
okánchoka	okánchoka	NOUN
okénbekon	okénbekon	ADV
oma	oma	ADJ
oma 	oma 	ADJ
ompáx	ompáx	NOUN
omísti	omísti	VERB[T]
on	on	POSTP
onkín	onkín	ADJ
onkínhati	onkínhati	VERB[T]
onkínti	onkínti	VERB[I]
onquín	onquín	ADJ
onquínhati	onquínhati	VERB[T]
onquínti	onquínti	VERB[I]
onsá	onsá	ADJ
onsáati	onsáati	VERB[T]
onsáti	onsáti	VERB[I]
oná ibo	oná ibo	NOUN
onáma	onáma	ADJ
onámashoco	onámashoco	ADJ
onámashoko	onámashoko	ADJ
onámati	onámati	VERB[T]
onámis	onámis	NOUN
onán	onán	ADJ
onán	onán	NOUN
onán 	onán 	NOUN
onánhati	onánhati	VERB[T]
onánpapa	onánpapa	NOUN
onánti	onánti	VERB[T]
onántima	onántima	ADJ
onántima	onántima	NOUN
onántita	onántita	NOUN
onánya	onánya	NOUN
onányati	onányati	NOUN
onénti	onénti	VERB[T]
onís	onís	ADJ
onís	onís	NOUN
onísamis	onísamis	NOUN
onísati	onísati	VERB[T]
onísti	onísti	VERB[I]
onón	onón	ADJ
onónhati	onónhati	VERB[T]
onónti	onónti	VERB[I]
opi	opi	NOUN
oquénbecon	oquénbecon	ADV
oro	oro	NOUN
oropampa	oropampa	NOUN
oránshi	oránshi	NOUN
oránti	oránti	VERB[T]
oríbia	oríbia	NOUN
oríbia 	oríbia 	NOUN
orópa	orópa	NOUN
oshkín	oshkín	NOUN
oshquín	oshquín	NOUN
oshtá	oshtá	ADJ
oshtásio	oshtásio	NOUN
oshtásio 	oshtásio 	NOUN
oshá	oshá	ADJ
oshá	oshá	NOUN
oshón	oshón	NOUN
ospítaro	ospítaro	NOUN
ostákia	ostákia	NOUN
ostánti	ostánti	VERB[T]
ostáquia	ostáquia	NOUN
osán	osán	NOUN
osánti	osánti	VERB[T]
osónti	osónti	NOUN
osónti	osónti	VERB[T]
osóti	osóti	VERB[I]
oténti	oténti	VERB[T]
otéxti	otéxti	VERB[T]
otíri	otíri	NOUN
otíri 	otíri 	NOUN
otó	otó	NOUN
oxná	oxná	ADJ
oxná panshín	oxná panshín	ADJ
oxné	oxné	NOUN
oxnéati	oxnéati	VERB[I]
oxnéti	oxnéti	VERB[I]
oxánti	oxánti	VERB[T]
oyáiti	oyáiti	VERB[I]
oínti	oínti	VERB[T]
oínxonmabi iconhati	oínxonmabi iconhati	NOUN
oínxonmabi ikonhati	oínxonmabi ikonhati	NOUN
oínyosma	oínyosma	ADJ
oísti	oísti	NOUN
oísti 	oísti 	NOUN
pa	pa	NOUN
pabíki	pabíki	NOUN
pabíqui	pabíqui	NOUN
pacho	pacho	ADV
pachóti	pachóti	VERB[I]
pahuéstia	pahuéstia	ADJ
pahuéxti	pahuéxti	VERB[T]
painon	painon	ADV
pake	pake	ADV
pakémati	pakémati	VERB[T]
pakéti	pakéti	VERB[I]
pakéx	pakéx	NOUN
pakéxti	pakéxti	VERB[T]
pakínti	pakínti	VERB[I]
panchá	panchá	ADJ
pancháati	pancháati	VERB[T]
pancháti	pancháti	VERB[I]
panon	panon	ADV
panshínhati	panshínhati	VERB[T]
panshínmati	panshínmati	VERB[T]
panshínti	panshínti	VERB[I]
panyón	panyón	NOUN
paná	paná	NOUN
panán	panán	NOUN
panéshti	panéshti	VERB[T]
panínti	panínti	VERB[T]
panó	panó	NOUN
pao	pao	ADV
papéti	papéti	VERB[T]
papía	papía	ADJ
papóti	papóti	VERB[T]
paque	paque	ADV
paquémati	paquémati	VERB[T]
paquéti	paquéti	VERB[I]
paquéx	paquéx	NOUN
paquéxti	paquéxti	VERB[T]
paquínti	paquínti	VERB[I]
pari	pari	ADV
pari 	pari 	ADV
paránta	paránta	NOUN
paránti	paránti	VERB[T]
paráxati	paráxati	VERB[T]
paráxiti	paráxiti	VERB[I]
paró	paró	ADJ
paró	paró	NOUN
paróya	paróya	ADJ
paskéti	paskéti	VERB[I]
pasná	pasná	ADJ
pasnáti	pasnáti	VERB[I]
pasquéti	pasquéti	VERB[I]
pastóro	pastóro	NOUN
patan	patan	ADV
patax	patax	POSTP
patsáti	patsáti	VERB[T]
patáxti	patáxti	VERB[I]
patéti	patéti	VERB[T]
patíati	patíati	VERB[T]
patónco	patónco	NOUN
patónko	patónko	NOUN
pawéstia	pawéstia	ADJ
pawéxti	pawéxti	VERB[T]
paxkín	paxkín	ADJ
paxkínhati	paxkínhati	VERB[T]
paxkínti	paxkínti	VERB[I]
paxmín	paxmín	NOUN
paxná	paxná	ADJ
paxquín	paxquín	ADJ
paxquínhati	paxquínhati	VERB[T]
paxquínti	paxquínti	VERB[I]
payánti	payánti	VERB[T]
payári	payári	NOUN
payáti	payáti	NOUN
payáti	payáti	VERB[I]
payón	payón	NOUN
payóti	payóti	VERB[I]
paénti	paénti	VERB[I]
paíkiti	paíkiti	VERB[I]
paíquiti	paíquiti	VERB[I]
paísma	paísma	ADJ
paísmaati	paísmaati	VERB[T]
paísmati	paísmati	VERB[I]
paón	paón	NOUN
paóya	paóya	ADJ
pecao	pecao	POSTP
pecá	pecá	NOUN
pekao	pekao	POSTP
peká	peká	NOUN
peké	peké	NOUN
pekéti	pekéti	VERB[I]
pempén	pempén	NOUN
peméxti	peméxti	VERB[T]
pencónti	pencónti	VERB[T]
pencóti	pencóti	VERB[I]
penkónti	penkónti	VERB[T]
penkóti	penkóti	VERB[I]
pené	pené	ADJ
penéati	penéati	VERB[T]
penéti	penéti	VERB[I]
peníchin	peníchin	NOUN
peníchinti	peníchinti	VERB[T]
peníncoro	peníncoro	NOUN
penínkoro	penínkoro	NOUN
peníti	peníti	VERB[I]
pequé	pequé	NOUN
pequéti	pequéti	VERB[I]
perén ati	perén ati	VERB[T]
perén iti	perén iti	VERB[I]
peréti	peréti	VERB[T]
peróntameeti	peróntameeti	VERB[I]
pesíti	pesíti	VERB[I]
petsáti	petsáti	VERB[I]
petsíti	petsíti	VERB[T]
petánti	petánti	VERB[I]
petó	petó	NOUN
pexcán	pexcán	NOUN
pexkán	pexkán	NOUN
pextín	pextín	ADJ
pextín	pextín	NOUN
pextínhati	pextínhati	VERB[T]
pexékea	pexékea	NOUN
pexéquea	pexéquea	NOUN
pexéti	pexéti	VERB[T]
peyásanti	peyásanti	VERB[T]
peánti	peánti	VERB[T]
peáraxti	peáraxti	NOUN
peóbenatian	peóbenatian	ADV
piacá	piacá	NOUN
piaká	piaká	NOUN
pichá	pichá	NOUN
picásti	picásti	VERB[I]
picóbena	picóbena	ADJ
picóti	picóti	VERB[I]
pikásti	pikásti	VERB[I]
pikóbena	pikóbena	ADJ
pikóti	pikóti	VERB[I]
pinéxti	pinéxti	VERB[T]
piní	piní	NOUN
pinímati	pinímati	VERB[T]
piníti	piníti	VERB[I]
pirás	pirás	NOUN
piríto	piríto	NOUN
piríto 	piríto 	NOUN
piró	piró	NOUN
piró 	piró 	NOUN
piróta	piróta	NOUN
piróta 	piróta 	NOUN
piscá	piscá	NOUN
piscó	piscó	ADJ
piscó	piscó	NOUN
piscóti	piscóti	VERB[I]
pishpísh	pishpísh	NOUN
pishtáco	pishtáco	NOUN
pishtáko	pishtáko	NOUN
pishtóke	pishtóke	NOUN
pishtón	pishtón	NOUN
pishtóque	pishtóque	NOUN
pishí	pishí	ADJ
pishí	pishí	NOUN
pishín	pishín	NOUN
pishínti	pishínti	VERB[I]
pishíti	pishíti	VERB[I]
piská	piská	NOUN
piskó	piskó	ADJ
piskó	piskó	NOUN
piskóti	piskóti	VERB[I]
pisánxehua	pisánxehua	NOUN
pisánxewa	pisánxewa	NOUN
pisára	pisára	NOUN
pitsómpiti	pitsómpiti	NOUN
pitsónti	pitsónti	VERB[T]
piá	piá	NOUN
piámpian	piámpian	NOUN
piónis	piónis	NOUN
pochínicon	pochínicon	POSTP
pochínikon	pochínikon	POSTP
pocárapa 	pocárapa 	NOUN
pocóti	pocóti	NOUN
pocóti	pocóti	VERB[I]
pokárapa	pokárapa	NOUN
pokóti	pokóti	NOUN
pokóti	pokóti	VERB[I]
ponchóti	ponchóti	VERB[T]
poncósh	poncósh	ADJ
ponhuéxti	ponhuéxti	VERB[T]
ponkósh	ponkósh	ADJ
ponskéti	ponskéti	VERB[I]
ponsquéti	ponsquéti	VERB[I]
ponsén	ponsén	NOUN
ponte	ponte	POSTP
ponté	ponté	ADJ
ponté	ponté	NOUN
pontéti	pontéti	VERB[I]
pontíti	pontíti	VERB[I]
pontónco	pontónco	NOUN
pontónko	pontónko	NOUN
ponwéxti	ponwéxti	VERB[T]
popó	popó	NOUN
poró	poró	NOUN
poróto	poróto	NOUN
posícho	posícho	NOUN
potsíti	potsíti	VERB[I]
potsótsori	potsótsori	NOUN
potá	potá	ADJ
potáati	potáati	VERB[T]
potáti	potáti	VERB[I]
poté	poté	ADJ
potó	potó	ADJ
potóti	potóti	VERB[I]
poxóti	poxóti	VERB[I]
poyán	poyán	NOUN
poíncosco	poíncosco	NOUN
poíncosco machíto	poíncosco machíto	NOUN
poíncoscon quencha	poíncoscon quencha	NOUN
poínki	poínki	NOUN
poínkosko	poínkosko	NOUN
poínkosko machíto	poínkosko machíto	NOUN
poínkoskon kencha	poínkoskon kencha	NOUN
poínqui	poínqui	NOUN
poíshin	poíshin	NOUN
páan	páan	NOUN
páanhati	páanhati	VERB[T]
pábe	pábe	ADJ
pábeati	pábeati	VERB[T]
pábeti	pábeti	VERB[I]
páboro	páboro	NOUN
páca	páca	NOUN
pácha	pácha	ADJ
páche$beti	páche$beti	NOUN
páchi	páchi	ADJ
páchiati	páchiati	VERB[T]
páchiti	páchiti	VERB[I]
pácho	pácho	NOUN
páchoki	páchoki	NOUN
páchoqui	páchoqui	NOUN
páchoti	páchoti	VERB[T]
pácopaco	pácopaco	NOUN
páe	páe	ADJ
páe	páe	NOUN
páeati	páeati	VERB[T]
páeri	páeri	NOUN
páerinin yónoti	páerinin yónoti	NOUN
páeti	páeti	VERB[I]
páico	páico	NOUN
páiko	páiko	NOUN
páira	páira	NOUN
pájina	pájina	NOUN
páka	páka	NOUN
páketi	páketi	VERB[T]
pákexeeti	pákexeeti	VERB[I]
pákopako	pákopako	NOUN
páma	páma	NOUN
pámehueti	pámehueti	VERB[I]
pámeweti	pámeweti	VERB[I]
pánacaati	pánacaati	VERB[I]
pánakaati	pánakaati	VERB[I]
pánati	pánati	NOUN
pánati	pánati	VERB[T]
páni	páni	NOUN
pániti	pániti	VERB[I]
pánixama	pánixama	NOUN
pántion	pántion	NOUN
páo	páo	NOUN
páoti	páoti	NOUN
páoti	páoti	VERB[T]
pápa	pápa	NOUN
pápaoma	pápaoma	ADJ
pápashoco	pápashoco	NOUN
pápashoko	pápashoko	NOUN
pápekeeti	pápekeeti	VERB[I]
pápequeeti	pápequeeti	VERB[I]
pápiti	pápiti	VERB[T]
páqueti	páqueti	VERB[T]
páquexeeti	páquexeeti	VERB[I]
párameeti	párameeti	VERB[I]
páranan ati	páranan ati	VERB[T]
páranan iti	páranan iti	VERB[I]
páranati	páranati	VERB[I]
párasa	párasa	NOUN
párasa 	párasa 	NOUN
páratai	páratai	NOUN
páro	páro	NOUN
páromaxca	páromaxca	NOUN
páromaxka	páromaxka	NOUN
páronoti	páronoti	NOUN
párorebo	párorebo	NOUN
pásajiro	pásajiro	NOUN
pásajiro 	pásajiro 	NOUN
páscoapishta 	páscoapishta 	NOUN
páshpi	páshpi	NOUN
pási	pási	NOUN
pásianti	pásianti	VERB[I]
pásianti 	pásianti 	VERB[I]
páskoapishta	páskoapishta	NOUN
pásto	pásto	NOUN
pátoron	pátoron	NOUN
pátsacaati	pátsacaati	VERB[I]
pátsakaati	pátsakaati	VERB[I]
pátsati	pátsati	VERB[T]
páxa	páxa	ADJ
páxaati	páxaati	VERB[T]
páxaininti	páxaininti	NOUN
páxati	páxati	VERB[I]
páxco	páxco	NOUN
páxko	páxko	NOUN
páxna	páxna	ADJ
páxnaati	páxnaati	VERB[I]
páxnati	páxnati	VERB[I]
páxteti	páxteti	VERB[T]
páyameeti	páyameeti	VERB[I]
páyameeti 	páyameeti 	VERB[I]
páyo	páyo	ADJ
páyoti	páyoti	VERB[T]
pécati	pécati	VERB[T]
pécharon	pécharon	NOUN
péchocoti	péchocoti	VERB[I]
péchokoti	péchokoti	VERB[I]
péchítí	péchítí	VERB[I]
pécoro	pécoro	NOUN
pékati	pékati	VERB[T]
péke	péke	NOUN
pékoro	pékoro	NOUN
pémexeeti	pémexeeti	VERB[I]
péna	péna	NOUN
péocooti	péocooti	VERB[I]
péokooti	péokooti	VERB[I]
péota	péota	NOUN
péoti	péoti	VERB[T]
péque	péque	NOUN
péracanti	péracanti	VERB[T]
péracati	péracati	VERB[T]
pérakanti	pérakanti	VERB[T]
pérakati	pérakati	VERB[T]
péri	péri	NOUN
péro	péro	NOUN
pésoti	pésoti	VERB[T]
pétipinti	pétipinti	VERB[T]
pétipiti	pétipiti	VERB[I]
pétsoti	pétsoti	VERB[T]
péxebua	péxebua	NOUN
péxmaati	péxmaati	VERB[I]
péxmati	péxmati	VERB[I]
péxo	péxo	NOUN
péyacati	péyacati	VERB[I]
péyakati	péyakati	VERB[I]
péí	péí	NOUN
pía	pía	NOUN
píakenyanti	píakenyanti	NOUN
píaquenyanti	píaquenyanti	NOUN
píchica	píchica	ADJ
píchika	píchika	ADJ
pícoti	pícoti	VERB[T]
píkero	píkero	NOUN
píkoti	píkoti	VERB[T]
píno	píno	NOUN
pínojihui	pínojihui	NOUN
pínojiwi	pínojiwi	NOUN
pío	pío	NOUN
píquero 	píquero 	NOUN
pírapira	pírapira	NOUN
píriconta 	píriconta 	NOUN
píriconta ati 	píriconta ati 	VERB[T]
pírikonta	pírikonta	NOUN
pírikonta ati	pírikonta ati	VERB[T]
pírimiso	pírimiso	NOUN
pírira	pírira	NOUN
pírira 	pírira 	NOUN
pírisirinti	pírisirinti	NOUN
pírisirinti 	pírisirinti 	NOUN
píriso	píriso	NOUN
píriso 	píriso 	NOUN
píriso ati	píriso ati	VERB[T]
píriso ati 	píriso ati 	VERB[T]
píriticanti 	píriticanti 	VERB[T]
píritikanti	píritikanti	VERB[T]
píro	píro	NOUN
píro 	píro 	NOUN
píroano	píroano	ADJ
píroano	píroano	NOUN
píroano 	píroano 	ADJ
píroano 	píroano 	NOUN
písa	písa	NOUN
píscoti	píscoti	VERB[T]
písha	písha	NOUN
píshati	píshati	VERB[T]
píshi	píshi	NOUN
píshkibo	píshkibo	NOUN
píshpachi	píshpachi	NOUN
píshquibo	píshquibo	NOUN
píshta	píshta	NOUN
píshtaati	píshtaati	VERB[T]
písi	písi	ADJ
písi	písi	NOUN
písiati	písiati	VERB[T]
písiti	písiti	VERB[I]
pískoti	pískoti	VERB[T]
píti	píti	NOUN
píti	píti	VERB[T]
pítima	pítima	NOUN
pítiriki	pítiriki	NOUN
pítiriqui	pítiriqui	NOUN
pítixeati	pítixeati	NOUN
pítso	pítso	NOUN
pítsocori 	pítsocori 	NOUN
pítsokori	pítsokori	NOUN
pítsoreshin	pítsoreshin	NOUN
píxteti	píxteti	VERB[T]
póa	póa	NOUN
póati	póati	VERB[I]
pócha	pócha	NOUN
póco	póco	NOUN
pócotexe	pócotexe	NOUN
pócoti	pócoti	VERB[T]
pócoxate	pócoxate	NOUN
pói	pói	NOUN
póipoitekere	póipoitekere	NOUN
póipoitequere	póipoitequere	NOUN
póitaran	póitaran	NOUN
póitere	póitere	NOUN
póiti	póiti	VERB[I]
póko	póko	NOUN
pókotexe	pókotexe	NOUN
pókoti	pókoti	VERB[T]
pókoxate	pókoxate	NOUN
póna	póna	NOUN
pónca	pónca	NOUN
pónchokiiti	pónchokiiti	VERB[I]
pónchoquiiti	pónchoquiiti	VERB[I]
póncoro	póncoro	NOUN
pónhuexeeti	pónhuexeeti	VERB[I]
pónka	pónka	NOUN
pónkoro	pónkoro	NOUN
póno	póno	NOUN
pónteti	pónteti	VERB[T]
pónwexeeti	pónwexeeti	VERB[I]
pónxteti	pónxteti	VERB[T]
pópo	pópo	NOUN
póri	póri	NOUN
pórisia	pórisia	NOUN
póro	póro	NOUN
pórobora	pórobora	NOUN
pórojisoro	pórojisoro	NOUN
pórojisoro 	pórojisoro 	NOUN
pósaca 	pósaca 	ADJ
pósaka	pósaka	ADJ
póso	póso	NOUN
pósta	pósta	NOUN
pótacaati	pótacaati	VERB[I]
pótakaati	pótakaati	VERB[I]
pótati	pótati	VERB[T]
póte	póte	NOUN
pótecaati	pótecaati	VERB[I]
pótekaati	pótekaati	VERB[I]
póteti	póteti	VERB[T]
póto	póto	NOUN
pótoati	pótoati	VERB[T]
pótoti	pótoti	VERB[I]
pótsiti	pótsiti	VERB[I]
póxati	póxati	VERB[T]
póxco	póxco	NOUN
póxko	póxko	NOUN
que	que	NOUN
quea	quea	POSTP
quean	quean	ADV
quebá	quebá	NOUN
quebáhua	quebáhua	NOUN
quebénocooti	quebénocooti	VERB[I]
quebénti	quebénti	VERB[T]
quebésti	quebésti	VERB[T]
quebéx	quebéx	ADJ
quebís	quebís	ADJ
quebíti	quebíti	NOUN
quebóx	quebóx	ADJ
quecháti	quecháti	VERB[T]
quechéxti	quechéxti	VERB[T]
quechínti	quechínti	VERB[T]
quechónti	quechónti	VERB[T]
quechóti	quechóti	VERB[T]
quecó	quecó	NOUN
quecósh	quecósh	ADJ
quecóti	quecóti	NOUN
quecóti	quecóti	VERB[I]
quehuáti	quehuáti	VERB[T]
quehué 	quehué 	NOUN
quehuéati	quehuéati	VERB[T]
quehuéxti	quehuéxti	VERB[T]
quehuéya	quehuéya	ADJ
quehuínti	quehuínti	VERB[T]
quehuíti	quehuíti	VERB[I]
quemexti	quemexti	VERB[T]
quempís	quempís	ADJ
quempís	quempís	NOUN
quempó	quempó	ADJ
quempó	quempó	NOUN
quempóya	quempóya	ADJ
quemánti	quemánti	VERB[T]
quemóntanti	quemóntanti	VERB[T]
quemóshti	quemóshti	VERB[T]
quemósti	quemósti	VERB[T]
quemóti	quemóti	VERB[I]
quenchá	quenchá	NOUN
quenchéx	quenchéx	ADJ
quenchónti	quenchónti	VERB[I]
quenchóntinti	quenchóntinti	VERB[I]
quenquéx	quenquéx	NOUN
quentí	quentí	NOUN
quenán	quenán	NOUN
quenáti	quenáti	VERB[I]
quenéati	quenéati	VERB[T]
quenéti	quenéti	VERB[I]
quenéxti	quenéxti	VERB[T]
quenéya	quenéya	ADJ
queníti	queníti	VERB[I]
quepásti	quepásti	VERB[T]
quepínti	quepínti	VERB[I]
quepíshiiti	quepíshiiti	VERB[I]
quepíshti	quepíshti	VERB[T]
quepíti	quepíti	VERB[I]
quequénti	quequénti	VERB[T]
quequéxti	quequéxti	VERB[I]
querás	querás	ADJ
querásati	querásati	VERB[T]
querásma	querásma	ADJ
querásti	querásti	VERB[T]
queré	queré	NOUN
queréati	queréati	VERB[T]
querénti	querénti	VERB[T]
querés ati	querés ati	VERB[T]
queréti	queréti	VERB[T]
queréx	queréx	ADJ
queréxatí	queréxatí	VERB[T]
queréxmesque	queréxmesque	NOUN
queréxti	queréxti	VERB[I]
queríro	queríro	NOUN
querón iti	querón iti	VERB[I]
queróti	queróti	VERB[T]
queróxati	queróxati	VERB[T]
quesca	quesca	POSTP
quescáaquin	quescáaquin	POSTP
quescáati	quescáati	VERB[T]
queshcánti	queshcánti	VERB[T]
queshcáti	queshcáti	VERB[I]
queshmón	queshmón	ADJ
queshtínti	queshtínti	VERB[T]
queshtíti	queshtíti	VERB[I]
quesháati	quesháati	NOUN
queshánti	queshánti	VERB[T]
quespín	quespín	NOUN
quespó	quespó	ADJ
quespóti	quespóti	VERB[T]
questáti	questáti	VERB[I]
questén	questén	ADJ
questénhati	questénhati	VERB[T]
quesénti	quesénti	VERB[T]
quesés	quesés	ADJ
quesíati	quesíati	VERB[T]
quesín	quesín	NOUN
quesínti	quesínti	VERB[T]
quetsámaati	quetsámaati	VERB[T]
quetsán ati	quetsán ati	VERB[T]
quetsán iti	quetsán iti	VERB[I]
quetsánti	quetsánti	VERB[T]
quetséti	quetséti	VERB[T]
quetsósti	quetsósti	VERB[T]
quetánti	quetánti	VERB[T]
quetáshati	quetáshati	VERB[T]
quetásti	quetásti	VERB[T]
quetáxiti	quetáxiti	VERB[I]
quetáxti	quetáxti	VERB[T]
quetéati	quetéati	VERB[T]
quetéti	quetéti	VERB[I]
quetéti	quetéti	VERB[T]
quetínti	quetínti	VERB[T]
quetó	quetó	NOUN
quetóshti	quetóshti	VERB[T]
quexbó	quexbó	NOUN
quexbón	quexbón	NOUN
quexcánti	quexcánti	VERB[I]
quexmíti	quexmíti	VERB[I]
quexpán	quexpán	ADJ
quextéti	quextéti	VERB[I]
quextó	quextó	ADJ
quextó	quextó	NOUN
quextóma	quextóma	ADJ
quextóti	quextóti	VERB[I]
quexá	quexá	ADV
quexá	quexá	POSTP
quexáti	quexáti	VERB[I]
quexáxti	quexáxti	VERB[T]
quexéti	quexéti	VERB[I]
quexóti	quexóti	VERB[T]
quexóxti	quexóxti	VERB[I]
queyá	queyá	ADJ
queyá	queyá	NOUN
queyáati	queyáati	VERB[T]
queyánti	queyánti	VERB[T]
queyáti	queyáti	VERB[I]
queyén	queyén	ADJ
queyón	queyón	NOUN
queyósh	queyósh	ADJ
queyóti	queyóti	VERB[I]
queíba	queíba	ADV
queíba	queíba	POSTP
queó 	queó 	NOUN
queónti	queónti	VERB[T]
queóti	queóti	VERB[I]
queóx	queóx	ADJ
qui	qui	POSTP
qui	qui	ADV
quibéntí	quibéntí	VERB[T]
quibésti	quibésti	VERB[T]
quibíti	quibíti	VERB[T]
quibón	quibón	NOUN
quicháti	quicháti	VERB[T]
quicháxti	quicháxti	VERB[T]
quichí	quichí	NOUN
quichírimina	quichírimina	NOUN
quichírimo	quichírimo	NOUN
quichíti	quichíti	VERB[I]
quichóshti	quichóshti	VERB[T]
quicósh	quicósh	ADJ
quihuásti	quihuásti	VERB[T]
quihuáti	quihuáti	VERB[T]
quihuéxti	quihuéxti	VERB[T]
quihuís	quihuís	ADJ
quihuíshti	quihuíshti	VERB[T]
quimánti	quimánti	VERB[T]
quimés	quimés	ADJ
quiméxti	quiméxti	VERB[T]
quimóshti	quimóshti	VERB[T]
quin	quin	ADV
quintósti	quintósti	VERB[T]
quinxón	quinxón	NOUN
quinán	quinán	NOUN
quináncasti	quináncasti	VERB[I]
quinánti	quinánti	VERB[T]
quinéxti	quinéxti	VERB[T]
quipásti	quipásti	VERB[T]
quipí	quipí	NOUN
quipíshti	quipíshti	VERB[T]
quipón	quipón	NOUN
quipóti	quipóti	VERB[I]
quiquénti	quiquénti	VERB[T]
quiquéxti	quiquéxti	VERB[T]
quiquín	quiquín	ADJ
quiquín	quiquín	ADV
quiquínhati	quiquínhati	VERB[T]
quiquínti	quiquínti	VERB[I]
quiran	quiran	ADV
quirínco	quirínco	NOUN
quirínica	quirínica	NOUN
quirípi 	quirípi 	NOUN
quirípinin iti	quirípinin iti	VERB[I]
quirísto 	quirísto 	NOUN
quishpímeeti	quishpímeeti	VERB[T]
quishpínti 	quishpínti 	VERB[T]
quismón	quismón	ADJ
quisquíti	quisquíti	VERB[I]
quisós 	quisós 	NOUN
quitsánti	quitsánti	VERB[T]
quitséti	quitséti	VERB[T]
quitsínti	quitsínti	VERB[I]
quitsíti	quitsíti	VERB[T]
quitsónti	quitsónti	VERB[T]
quitsósti	quitsósti	VERB[T]
quitára 	quitára 	NOUN
quitásti	quitásti	VERB[T]
quitéti	quitéti	VERB[T]
quitéxti	quitéxti	VERB[I]
quitísati	quitísati	VERB[T]
quitísiti	quitísiti	VERB[I]
quitósati	quitósati	VERB[T]
quitóshti	quitóshti	VERB[I]
quitósiti	quitósiti	VERB[I]
quixaxti	quixaxti	VERB[T]
quixpé	quixpé	ADJ
quixtéti	quixtéti	VERB[I]
quién	quién	ADJ
quiósh	quiósh	ADJ
quióx	quióx	ADJ
qupequexeeti	qupequexeeti	VERB[I]
québiiti	québiiti	VERB[I]
québisasa	québisasa	NOUN
québo	québo	NOUN
québorox	québorox	NOUN
quéchiti	quéchiti	VERB[I]
quéchoquiiti	quéchoquiiti	VERB[I]
quécoti	quécoti	VERB[T]
quéen	quéen	NOUN
quéenti	quéenti	VERB[I]
quéeti	quéeti	NOUN
quéeti	quéeti	VERB[T]
quéhueti	quéhueti	VERB[T]
quémpo	quémpo	NOUN
quéna	quéna	NOUN
quénati	quénati	VERB[T]
quéne 	quéne 	NOUN
quéneti	quéneti	VERB[T]
quéni 	quéni 	NOUN
quénibiti	quénibiti	NOUN
quénioma	quénioma	NOUN
quéniqueni	quéniqueni	ADJ
quénoti	quénoti	VERB[T]
quénshi	quénshi	NOUN
quénshiti	quénshiti	VERB[I]
quénsho	quénsho	ADJ
quénshoti	quénshoti	NOUN
quénshoti	quénshoti	VERB[T]
quénto	quénto	ADJ
quépemeeti 	quépemeeti 	VERB[I]
quépenti 	quépenti 	VERB[T]
quépequeeti	quépequeeti	VERB[I]
quépeti	quépeti	VERB[I]
quépoti	quépoti	VERB[I]
quésha	quésha	NOUN
quéshati	quéshati	VERB[I]
quéshca	quéshca	ADJ
quéshpa	quéshpa	ADJ
quésoti	quésoti	VERB[T]
quéstati	quéstati	VERB[T]
quésto	quésto	ADJ
quéxeti	quéxeti	VERB[T]
quéxme	quéxme	ADJ
quéxmi	quéxmi	ADJ
quéxmiati	quéxmiati	VERB[T]
quéxmiti	quéxmiti	VERB[I]
quéxpe	quéxpe	ADJ
quéxqueati	quéxqueati	VERB[T]
quéxqueti	quéxqueti	VERB[I]
quéxteti	quéxteti	VERB[T]
quéyoti	quéyoti	ADV
quéyoti	quéyoti	VERB[T]
quícho	quícho	ADJ
quíisti	quíisti	VERB[T]
químisha	químisha	ADJ
químishai	químishai	ADV
quína	quína	NOUN
quíni	quíni	NOUN
quíniati	quíniati	VERB[T]
quínto	quínto	ADJ
quíquini	quíquini	ADV
quírica	quírica	NOUN
quíro	quíro	NOUN
quírocaramo 	quírocaramo 	NOUN
quírosin 	quírosin 	NOUN
quíshi	quíshi	NOUN
quíshioma	quíshioma	ADJ
quíshioma	quíshioma	NOUN
quíshpina	quíshpina	ADJ
quísoti	quísoti	VERB[T]
quíspo	quíspo	ADJ
quísquiti	quísquiti	VERB[T]
quístati	quístati	VERB[T]
quísto	quísto	ADJ
quítamoro	quítamoro	NOUN
quítamoron iti	quítamoron iti	VERB[I]
quíxme	quíxme	ADJ
quíxni	quíxni	NOUN
quíxteti	quíxteti	VERB[T]
qúexá	qúexá	NOUN
ra	ra	ADV
ra	ra	NOUN
rabe	rabe	ADV
rabé	rabé	ADJ
rabéti	rabéti	ADV
rabéti	rabéti	VERB[I]
rabétia	rabétia	ADJ
rabín	rabín	ADJ
rabín jahuequi	rabín jahuequi	NOUN
rabín jaweki	rabín jaweki	NOUN
rabínhoma	rabínhoma	ADJ
rabínti	rabínti	VERB[I]
rabíri	rabíri	NOUN
rabíri 	rabíri 	NOUN
racháti	racháti	VERB[T]
rachóti	rachóti	VERB[T]
racánti	racánti	VERB[T]
racáti	racáti	NOUN
racáti	racáti	VERB[I]
racóti	racóti	NOUN
racóti	racóti	VERB[I]
rahuí	rahuí	NOUN
rahuíati	rahuíati	VERB[T]
rahuínti	rahuínti	VERB[T]
rahuíti	rahuíti	VERB[I]
rakánti	rakánti	VERB[T]
rakáti	rakáti	NOUN
rakáti	rakáti	VERB[I]
raké	raké	ADJ
rakéati	rakéati	VERB[T]
rakéti	rakéti	VERB[I]
rakéyosma	rakéyosma	ADJ
rakíri	rakíri	NOUN
rakóti	rakóti	NOUN
rakóti	rakóti	VERB[I]
rampára	rampára	NOUN
rampárin	rampárin	NOUN
rampépi	rampépi	NOUN
ramáma	ramáma	ADV
ramánti	ramánti	VERB[T]
raménooti	raménooti	VERB[I]
raménoti	raménoti	VERB[T]
ramíati	ramíati	VERB[T]
ramíti	ramíti	VERB[I]
ramón	ramón	NOUN
ranbéti	ranbéti	VERB[I]
ransá	ransá	NOUN
rantsínti	rantsínti	VERB[I]
rantsísco	rantsísco	NOUN
rantsísko	rantsísko	NOUN
rantónco	rantónco	NOUN
rantónko	rantónko	NOUN
ranáhueti	ranáhueti	VERB[T]
ranáweti	ranáweti	VERB[T]
ranénke	ranénke	NOUN
ranénque	ranénque	NOUN
raníiri	raníiri	NOUN
raníiri 	raníiri 	NOUN
ranó	ranó	NOUN
ranón	ranón	NOUN
rapésteti	rapésteti	VERB[T]
rapíchi	rapíchi	NOUN
rapíchi 	rapíchi 	NOUN
rapís	rapís	NOUN
raqué	raqué	ADJ
raquéati	raquéati	VERB[T]
raquéti	raquéti	VERB[I]
raquéyosma	raquéyosma	ADJ
raquíri	raquíri	NOUN
rashíco	rashíco	NOUN
rashíko	rashíko	NOUN
rastón	rastón	ADJ
rastón	rastón	NOUN
rastónti	rastónti	VERB[I]
raté	raté	NOUN
ratéti	ratéti	VERB[I]
ratín joi	ratín joi	NOUN
ratín joi 	ratín joi 	NOUN
rató	rató	NOUN
ratóti	ratóti	VERB[I]
ratóti	ratóti	VERB[T]
rawí	rawí	NOUN
rawíati	rawíati	VERB[T]
rawínti	rawínti	VERB[T]
rawíti	rawíti	VERB[I]
raxcán 	raxcán 	NOUN
raxkán	raxkán	NOUN
rayá	rayá	ADJ
rayáti	rayáti	VERB[I]
rayón	rayón	NOUN
rayós	rayós	NOUN
rayósainbo	rayósainbo	NOUN
raínshati	raínshati	VERB[T]
raínshiti	raínshiti	VERB[I]
raóati	raóati	VERB[T]
raómis	raómis	NOUN
raónti	raónti	VERB[T]
raóti	raóti	NOUN
raóti	raóti	VERB[I]
raóx	raóx	ADJ
raóya	raóya	ADJ
rebésti	rebésti	VERB[T]
rebíti	rebíti	VERB[T]
rechán	rechán	NOUN
rechán 	rechán 	NOUN
rechóshti	rechóshti	VERB[T]
rehuínti	rehuínti	VERB[T]
rekén	rekén	ADJ
rekén	rekén	NOUN
rekénhakin	rekénhakin	ADV
rekénsho	rekénsho	ADJ
rekénti	rekénti	VERB[I]
rekín	rekín	NOUN
rekínkini	rekínkini	NOUN
renenké	renenké	ADJ
renenqué	renenqué	ADJ
repínti	repínti	NOUN
repínti	repínti	VERB[T]
repóti	repóti	NOUN
requén	requén	ADJ
requén	requén	NOUN
requénhaquin	requénhaquin	ADV
requénsho	requénsho	ADJ
requénti	requénti	VERB[I]
requín	requín	NOUN
requínquini	requínquini	NOUN
res	res	ADV
reskéti	reskéti	VERB[I]
resquéti	resquéti	VERB[I]
resénbi	resénbi	ADJ
resénbinati	resénbinati	VERB[T]
resés	resés	ADJ
retísati	retísati	VERB[T]
retísiti	retísiti	VERB[I]
rewínti	rewínti	VERB[T]
rexté	rexté	ADJ
rexó	rexó	NOUN
ri sf	ri sf	ADV
riba	riba	ADV
ribíca 	ribíca 	NOUN
ribíka	ribíka	NOUN
ribín	ribín	NOUN
ribínti	ribínti	VERB[T]
ribínya	ribínya	ADJ
ribójo	ribójo	NOUN
ribójo 	ribójo 	NOUN
ricánti	ricánti	VERB[T]
ricáranti	ricáranti	VERB[T]
rijó	rijó	NOUN
rikánti	rikánti	VERB[T]
rikáranti	rikáranti	VERB[T]
rimántanti	rimántanti	VERB[T]
rimínyo	rimínyo	NOUN
rimínyo 	rimínyo 	NOUN
rimítirio	rimítirio	NOUN
rimítirio 	rimítirio 	NOUN
rimón	rimón	NOUN
rimónininti	rimónininti	NOUN
rinjón	rinjón	NOUN
ripóca	ripóca	NOUN
ripóka	ripóka	NOUN
riros	riros	NOUN
risbí	risbí	NOUN
risbíati	risbíati	VERB[T]
risbíti	risbíti	VERB[I]
rishkí	rishkí	NOUN
rishkíti	rishkíti	NOUN
rishkíti	rishkíti	VERB[I]
rishquí	rishquí	NOUN
rishquíti	rishquíti	NOUN
rishquíti	rishquíti	VERB[I]
ristánti	ristánti	VERB[T]
ristánti 	ristánti 	VERB[T]
risánti	risánti	VERB[T]
risímitoro	risímitoro	NOUN
risímitoro 	risímitoro 	NOUN
risína	risína	NOUN
risína 	risína 	NOUN
ritás	ritás	NOUN
ritás 	ritás 	NOUN
riácono 	riácono 	NOUN
riákono	riákono	NOUN
riára	riára	NOUN
riára 	riára 	NOUN
rión	rión	NOUN
rión 	rión 	NOUN
riós	riós	NOUN
riós 	riós 	NOUN
riósaa	riósaa	NOUN
robín	robín	NOUN
robín 	robín 	NOUN
robírito	robírito	NOUN
robírito 	robírito 	NOUN
rocás 	rocás 	NOUN
rokás	rokás	NOUN
ronki	ronki	ADV
ronkén	ronkén	NOUN
ronqui 	ronqui 	ADV
ronquén	ronquén	NOUN
rontánhis	rontánhis	NOUN
rontánti	rontánti	VERB[T]
ronáti	ronáti	VERB[I]
ronín	ronín	NOUN
ronín 	ronín 	NOUN
ronón ehua	ronón ehua	NOUN
ronón ewa	ronón ewa	NOUN
ronónbena	ronónbena	NOUN
rosmíra	rosmíra	NOUN
rosmíra 	rosmíra 	NOUN
rostíca	rostíca	NOUN
rostíka	rostíka	NOUN
rosína	rosína	NOUN
rosína 	rosína 	NOUN
rosíra	rosíra	NOUN
rosíra 	rosíra 	NOUN
rotóti	rotóti	VERB[I]
roá	roá	NOUN
roáncabi	roáncabi	NOUN
roánkabi	roánkabi	NOUN
roáti	roáti	VERB[I]
roís	roís	NOUN
roís 	roís 	NOUN
ráanti	ráanti	VERB[T]
ráaxeti	ráaxeti	VERB[I]
rábicaati 	rábicaati 	VERB[I]
rábikaati	rábikaati	VERB[I]
rábiti	rábiti	VERB[T]
rábo	rábo	NOUN
ráboxo	ráboxo	NOUN
ráboxo 	ráboxo 	NOUN
rácahuati	rácahuati	VERB[T]
rácator	rácator	NOUN
ráchokiiti	ráchokiiti	VERB[I]
ráchoquiiti	ráchoquiiti	VERB[I]
rácoti	rácoti	VERB[T]
ráe	ráe	ADJ
ráeananai	ráeananai	NOUN
ráeananti	ráeananti	VERB[I]
ráeati	ráeati	VERB[T]
ráeti	ráeti	VERB[I]
ráhua	ráhua	NOUN
ráhuaira 	ráhuaira 	NOUN
ráhuati	ráhuati	VERB[I]
ráhuinananti	ráhuinananti	VERB[I]
ráibo	ráibo	NOUN
ráisikiiti	ráisikiiti	VERB[I]
ráisiquiiti	ráisiquiiti	VERB[I]
rákator	rákator	NOUN
rákawati	rákawati	VERB[T]
rákexto paróya	rákexto paróya	NOUN
rákoti	rákoti	VERB[T]
ráma	ráma	ADV
rámatian	rámatian	ADV
rámaya	rámaya	ADJ
rámayati	rámayati	VERB[T]
rámi	rámi	ADJ
rámiati	rámiati	VERB[T]
rámpa	rámpa	NOUN
ránbeti	ránbeti	VERB[T]
ráncho	ráncho	NOUN
ránchoshiti	ránchoshiti	VERB[I]
ránco	ránco	NOUN
ráni	ráni	NOUN
ránko	ránko	NOUN
ránomis	ránomis	ADJ
ránoti	ránoti	VERB[T]
ránsati	ránsati	VERB[I]
ránxiti	ránxiti	VERB[I]
ráo	ráo	NOUN
ráoma	ráoma	NOUN
ráomeeti	ráomeeti	VERB[I]
ráopox	ráopox	NOUN
ráora	ráora	NOUN
ráora 	ráora 	NOUN
ráorio	ráorio	NOUN
ráorio 	ráorio 	NOUN
ráoxobo	ráoxobo	NOUN
ráoya	ráoya	ADJ
rápoi	rápoi	NOUN
ráquexto paróya	ráquexto paróya	NOUN
rárebo	rárebo	NOUN
rárebokeska	rárebokeska	ADJ
ráreboquesca	ráreboquesca	ADJ
rário	rário	NOUN
rároti	rároti	VERB[I]
rásaro	rásaro	NOUN
rásaro 	rásaro 	NOUN
rásaro isin	rásaro isin	NOUN
rásaroya	rásaroya	ADJ
rásati	rásati	VERB[T]
rásenen	rásenen	NOUN
rásiti	rásiti	VERB[I]
rásoikiiti	rásoikiiti	NOUN
rásoikiiti	rásoikiiti	VERB[I]
rásoiquiiti	rásoiquiiti	NOUN
rásoiquiiti	rásoiquiiti	VERB[I]
ráta	ráta	NOUN
ráteti	ráteti	VERB[T]
ráto	ráto	NOUN
rátonron	rátonron	ADJ
rátonron	rátonron	NOUN
rátsocasti	rátsocasti	VERB[I]
rátsokasti	rátsokasti	VERB[I]
rátsoti	rátsoti	VERB[I]
ráwa	ráwa	NOUN
ráwaira	ráwaira	NOUN
ráwati	ráwati	VERB[I]
ráwinananti	ráwinananti	VERB[I]
réa	réa	NOUN
rébo	rébo	NOUN
réboki	réboki	ADV
réboki	réboki	POSTP
rébokiri	rébokiri	ADV
réboqui	réboqui	ADV
réboqui	réboqui	POSTP
réboquiri	réboquiri	ADV
réhue	réhue	NOUN
réncati 	réncati 	VERB[T]
réneti	réneti	VERB[T]
réniti	réniti	NOUN
réniti	réniti	VERB[T]
rénkati	rénkati	VERB[T]
réocooti	réocooti	VERB[I]
réokooti	réokooti	VERB[I]
réoti	réoti	VERB[T]
répeke	répeke	NOUN
répeque	répeque	NOUN
répiti	répiti	VERB[I]
réracaati	réracaati	VERB[I]
rérakaati	rérakaati	VERB[I]
rérati	rérati	VERB[T]
réreiti	réreiti	VERB[I]
résenena	résenena	NOUN
réshiti	réshiti	VERB[I]
résho	résho	NOUN
réshoti	réshoti	VERB[I]
rétecaati	rétecaati	VERB[I]
rétekaati	rétekaati	VERB[I]
rétemis	rétemis	NOUN
réteti	réteti	VERB[T]
réwe	réwe	NOUN
réxni	réxni	NOUN
réyacati	réyacati	VERB[I]
réyakati	réyakati	VERB[I]
réyati	réyati	VERB[T]
ríbirinti	ríbirinti	VERB[T]
ríbirinti 	ríbirinti 	VERB[T]
ríbirita	ríbirita	NOUN
ríbiro	ríbiro	NOUN
ríbiro 	ríbiro 	NOUN
ríbision	ríbision	NOUN
ríbision 	ríbision 	NOUN
ríbojanti	ríbojanti	VERB[T]
ríbojanti 	ríbojanti 	VERB[T]
ríbora	ríbora	NOUN
ríbora 	ríbora 	NOUN
ríca	ríca	NOUN
rícaton	rícaton	NOUN
ríchi	ríchi	NOUN
ríka	ríka	NOUN
ríkaton	ríkaton	NOUN
ríkision	ríkision	NOUN
ríma	ríma	NOUN
ríma 	ríma 	NOUN
rímotiro	rímotiro	NOUN
rínki	rínki	NOUN
ríno	ríno	NOUN
ríno 	ríno 	NOUN
rínosironti	rínosironti	NOUN
rínosironti 	rínosironti 	NOUN
rínqui	rínqui	NOUN
rínsi	rínsi	NOUN
rínsi 	rínsi 	NOUN
ríoparo	ríoparo	NOUN
ríoparo 	ríoparo 	NOUN
ríosen nete	ríosen nete	NOUN
ríosen nete 	ríosen nete 	NOUN
ríosen noa copi acá jahuéqui	ríosen noa copi acá jahuéqui	NOUN
ríosen noa kopi aká jawéki	ríosen noa kopi aká jawéki	NOUN
ríosen shinán	ríosen shinán	NOUN
ríosen shinán 	ríosen shinán 	NOUN
ríquision 	ríquision 	NOUN
ríriiti	ríriiti	VERB[I]
ríro	ríro	NOUN
ríshkikaati	ríshkikaati	VERB[I]
ríshkiti	ríshkiti	VERB[T]
ríshquicaati	ríshquicaati	VERB[I]
ríshquiti	ríshquiti	VERB[T]
rísta	rísta	NOUN
rítira	rítira	NOUN
rítira 	rítira 	NOUN
rítoro	rítoro	NOUN
rítoro 	rítoro 	NOUN
róa	róa	ADJ
róa	róa	NOUN
róati	róati	VERB[I]
rócaroca	rócaroca	NOUN
rócho	rócho	NOUN
rócho 	rócho 	NOUN
róco	róco	ADJ
rócoti	rócoti	VERB[I]
rócotoro 	rócotoro 	NOUN
róe	róe	NOUN
róiroi	róiroi	NOUN
rójiri	rójiri	NOUN
rókaroka	rókaroka	NOUN
róko	róko	ADJ
rókoti	rókoti	VERB[I]
rókotoro	rókotoro	NOUN
róma jonibo	róma jonibo	NOUN
róma jonibo 	róma jonibo 	NOUN
róme	róme	NOUN
rómexei	rómexei	NOUN
róna	róna	NOUN
rónisnete	rónisnete	NOUN
rónisnete 	rónisnete 	NOUN
róno	róno	NOUN
rónocaxo	rónocaxo	NOUN
rónokaxo	rónokaxo	NOUN
rónopeia	rónopeia	NOUN
róntameeti	róntameeti	VERB[I]
róo	róo	NOUN
róomaban	róomaban	NOUN
róon	róon	NOUN
róonbi	róonbi	NOUN
róooconiti	róooconiti	VERB[I]
róookoniti	róookoniti	VERB[I]
róra	róra	NOUN
róra 	róra 	NOUN
róriti	róriti	NOUN
rórocooti	rórocooti	VERB[I]
rórokooti	rórokooti	VERB[I]
róroti	róroti	VERB[T]
rósa	rósa	NOUN
rósia	rósia	NOUN
rósia 	rósia 	NOUN
rósio	rósio	NOUN
rósio 	rósio 	NOUN
róta	róta	NOUN
róta 	róta 	NOUN
róti	róti	NOUN
rótoti	rótoti	VERB[T]
sa	sa	NOUN
sabán	sabán	NOUN
sabáno	sabáno	NOUN
sahuéti	sahuéti	VERB[T]
sakío	sakío	NOUN
samá	samá	NOUN
samán	samán	NOUN
samária	samária	NOUN
sankén	sankén	ADJ
sankén bea	sankén bea	NOUN
sankénti	sankénti	VERB[I]
sanquén	sanquén	ADJ
sanquén bea 	sanquén bea 	NOUN
sanquénti	sanquénti	VERB[I]
santária	santária	NOUN
santén	santén	NOUN
santíra	santíra	NOUN
santíra 	santíra 	NOUN
santós	santós	NOUN
sanánco	sanánco	NOUN
sanánko	sanánko	NOUN
sanánti	sanánti	VERB[T]
sanín	sanín	NOUN
sapáto	sapáto	NOUN
sapén	sapén	NOUN
saquío 	saquío 	NOUN
sarámpi	sarámpi	NOUN
satán	satán	ADJ
sawéti	sawéti	VERB[T]
sayánti	sayánti	VERB[T]
saíati	saíati	VERB[T]
saíiti	saíiti	VERB[I]
sebíti	sebíti	VERB[I]
sebíti 	sebíti 	VERB[I]
sekénti	sekénti	VERB[T]
sekéti	sekéti	VERB[I]
senáti	senáti	VERB[I]
senén	senén	ADJ
senén	senén	POSTP
senénbires	senénbires	ADV
senénhati	senénhati	VERB[T]
senénshaman	senénshaman	ADV
senénti	senénti	VERB[I]
sepá	sepá	NOUN
sequénti	sequénti	VERB[T]
sequéti	sequéti	VERB[I]
seré	seré	ADJ
seré	seré	NOUN
seréati	seréati	VERB[T]
seró	seró	ADJ
seróati	seróati	VERB[I]
seróti	seróti	VERB[I]
seténhati	seténhati	VERB[T]
setéti	setéti	VERB[I]
seyá	seyá	ADJ
seyá	seyá	NOUN
seyáti	seyáti	VERB[I]
sha	sha	NOUN
shacónti	shacónti	VERB[T]
shacóti	shacóti	VERB[I]
shahuáno	shahuáno	NOUN
shakónti	shakónti	VERB[T]
shakóti	shakóti	VERB[I]
shaman	shaman	ADV
shanó	shanó	NOUN
shawáno	shawáno	NOUN
shekésh	shekésh	NOUN
shequésh	shequésh	NOUN
shihuéhue	shihuéhue	NOUN
shimón	shimón	NOUN
shin	shin	ADV
shinshín	shinshín	NOUN
shinán	shinán	NOUN
shinánbenoti	shinánbenoti	VERB[I]
shináncayata	shináncayata	ADV
shinánhati	shinánhati	VERB[T]
shinánhoma	shinánhoma	ADJ
shinánkayata	shinánkayata	ADV
shinánti	shinánti	VERB[I]
shinánti	shinánti	VERB[T]
shinánya	shinánya	ADJ
shiní	shiní	NOUN
shinípentsin	shinípentsin	NOUN
shinítapon	shinítapon	NOUN
shiráco	shiráco	NOUN
shiráko	shiráko	NOUN
shirínca	shirínca	NOUN
shirínka	shirínka	NOUN
shisháco	shisháco	NOUN
shisháko	shisháko	NOUN
shitáti	shitáti	VERB[I]
shiwéwe	shiwéwe	NOUN
shoco	shoco	ADV
shoco 	shoco 	ADV
shohuáhua	shohuáhua	NOUN
shoko	shoko	ADV
shomón	shomón	ADJ
shomón	shomón	NOUN
shomónti	shomónti	VERB[I]
shoní	shoní	NOUN
shoró	shoró	NOUN
shoróati	shoróati	VERB[T]
shoróti	shoróti	VERB[I]
showáwa	showáwa	NOUN
shácaati	shácaati	NOUN
shácaati	shácaati	VERB[T]
shácaiti	shácaiti	VERB[I]
shácomeeti	shácomeeti	VERB[I]
shákaati	shákaati	NOUN
shákaati	shákaati	VERB[T]
shákaiti	shákaiti	VERB[I]
shákomeeti	shákomeeti	VERB[I]
shánca	shánca	NOUN
shánka	shánka	NOUN
shánti	shánti	NOUN
shánti 	shánti 	NOUN
sháo	sháo	ADJ
sháoti	sháoti	VERB[I]
sháraiti	sháraiti	VERB[I]
shéati	shéati	VERB[T]
shéiti	shéiti	VERB[I]
shépa	shépa	ADJ
shépaati	shépaati	NOUN
shépati	shépati	VERB[I]
shéreiti	shéreiti	VERB[I]
shíari	shíari	NOUN
shín iti	shín iti	VERB[I]
shínacoxo	shínacoxo	NOUN
shínakoxo	shínakoxo	NOUN
shínamanres	shínamanres	ADV
shínameeti	shínameeti	VERB[I]
shínca	shínca	NOUN
shínka	shínka	NOUN
shíno	shíno	NOUN
shínti	shínti	NOUN
shío	shío	NOUN
shípi	shípi	NOUN
shípibo	shípibo	NOUN
shípimabichi	shípimabichi	NOUN
shíriiti	shíriiti	VERB[I]
shíroati	shíroati	VERB[T]
shírojane	shírojane	NOUN
shíroti	shíroti	VERB[I]
shíshi	shíshi	NOUN
shítati	shítati	VERB[T]
shóati.	shóati.	VERB[T]
shócores	shócores	ADV
shóiti	shóiti	VERB[I]
shókikaati	shókikaati	VERB[I]
shókiti	shókiti	NOUN
shókiti	shókiti	VERB[T]
shókores	shókores	ADV
shónta	shónta	NOUN
shóntiri	shóntiri	NOUN
shóquicaati	shóquicaati	VERB[I]
shóquiti	shóquiti	NOUN
shóquiti	shóquiti	VERB[T]
shóroati	shóroati	NOUN
shóroati	shóroati	VERB[T]
shóroiti	shóroiti	VERB[I]
sibá	sibá	ADJ
sibáati	sibáati	VERB[T]
sibára	sibára	NOUN
sibára 	sibára 	NOUN
sibáti	sibáti	VERB[I]
sibó	sibó	NOUN
sibória	sibória	NOUN
sibória 	sibória 	NOUN
sicá	sicá	ADJ
sicá	sicá	NOUN
sicóntina 	sicóntina 	NOUN
sihuáti	sihuáti	VERB[I]
sihuínti	sihuínti	VERB[T]
siká	siká	ADJ
siká	siká	NOUN
sikíti	sikíti	VERB[I]
sikóntina	sikóntina	NOUN
simpíra	simpíra	NOUN
simánan	simánan	NOUN
simánan 	simánan 	NOUN
simínto	simínto	NOUN
simínto 	simínto 	NOUN
simón	simón	NOUN
sintábo	sintábo	NOUN
sintábo 	sintábo 	NOUN
sintán	sintán	NOUN
sintóra	sintóra	NOUN
sintóra 	sintóra 	NOUN
sinyóra	sinyóra	NOUN
sinyóra 	sinyóra 	NOUN
sinyóro	sinyóro	NOUN
sinyóro 	sinyóro 	NOUN
siná	siná	ADJ
siná	siná	NOUN
sináati	sináati	VERB[I]
sináti	sináti	VERB[I]
sipán	sipán	NOUN
sipícho	sipícho	NOUN
sipícho 	sipícho 	NOUN
sipón	sipón	NOUN
siquíti	siquíti	VERB[I]
siránti	siránti	VERB[T]
sirócho	sirócho	NOUN
sirócho 	sirócho 	NOUN
siwáti	siwáti	VERB[I]
siwínti	siwínti	VERB[T]
sión	sión	NOUN
sión ati	sión ati	VERB[T]
sión iti	sión iti	VERB[I]
sománti	sománti	VERB[T]
somónti	somónti	VERB[I]
sontáro	sontáro	NOUN
sontáro 	sontáro 	NOUN
sopóati	sopóati	VERB[T]
sopóti	sopóti	VERB[I]
soríma	soríma	NOUN
soróma	soróma	NOUN
soróma 	soróma 	NOUN
soróti	soróti	VERB[I]
sosána	sosána	NOUN
sotánti	sotánti	VERB[T]
sotó	sotó	ADJ
soí	soí	ADJ
soíti	soíti	VERB[I]
sáaati	sáaati	VERB[T]
sáaiti	sáaiti	VERB[I]
sácarias	sácarias	NOUN
sáhuemati	sáhuemati	VERB[T]
sáhueti	sáhueti	NOUN
sáhueti	sáhueti	VERB[I]
sákarias	sákarias	NOUN
sákiiti	sákiiti	VERB[I]
sákiristano	sákiristano	NOUN
sáma	sáma	NOUN
sámaritano	sámaritano	NOUN
sámo	sámo	NOUN
sámoiro	sámoiro	NOUN
sámoiro 	sámoiro 	NOUN
sáni	sáni	NOUN
sánitario	sánitario	NOUN
sánjoan pishta	sánjoan pishta	NOUN
sántasina	sántasina	NOUN
sántasina 	sántasina 	NOUN
sántiaco	sántiaco	NOUN
sántiako	sántiako	NOUN
sánto	sánto	NOUN
sántopaeri	sántopaeri	NOUN
sántorabi	sántorabi	NOUN
sáoro	sáoro	NOUN
sáoro 	sáoro 	NOUN
sápa	sápa	ADJ
sápeman tita	sápeman tita	NOUN
sápiton	sápiton	NOUN
sáquiiti	sáquiiti	VERB[I]
sáquiristano	sáquiristano	NOUN
sára	sára	NOUN
sára 	sára 	NOUN
sárajinto	sárajinto	NOUN
sárajinto 	sárajinto 	NOUN
sári	sári	NOUN
sárisariiti	sárisariiti	VERB[I]
sáromon	sáromon	NOUN
sároranti	sároranti	VERB[T]
sároranti 	sároranti 	VERB[T]
sároro	sároro	NOUN
sátanas	sátanas	NOUN
sáwemati	sáwemati	VERB[T]
sáweti	sáweti	NOUN
sáweti	sáweti	VERB[I]
sáya	sáya	NOUN
sébe	sébe	NOUN
sébiti	sébiti	VERB[T]
sébiti 	sébiti 	VERB[T]
séiti	séiti	VERB[I]
séketi	séketi	VERB[T]
sémpa	sémpa	NOUN
sénca	sénca	NOUN
sénenain	sénenain	ADV
sénenainco	sénenainco	POSTP
sénenainko	sénenainko	POSTP
sénka	sénka	NOUN
sénoti	sénoti	VERB[T]
sépati	sépati	VERB[T]
séqueti	séqueti	VERB[T]
sére	sére	NOUN
sése	sése	ADJ
séseati	séseati	VERB[T]
séseti	séseti	VERB[I]
síbara	síbara	NOUN
síbara 	síbara 	NOUN
sícati	sícati	VERB[T]
síhuati	síhuati	VERB[T]
síin	síin	NOUN
síin ati	síin ati	VERB[T]
síin iti	síin iti	VERB[I]
síiti	síiti	VERB[I]
síkati	síkati	VERB[T]
síki	síki	NOUN
síkino	síkino	NOUN
sína	sína	NOUN
sínco	sínco	NOUN
sínko	sínko	NOUN
síno	síno	NOUN
sínopepo	sínopepo	NOUN
sínta	sínta	NOUN
sínti	sínti	NOUN
sío	sío	NOUN
sípo	sípo	NOUN
síqui	síqui	NOUN
síquino 	síquino 	NOUN
síra	síra	NOUN
síra 	síra 	NOUN
síras	síras	NOUN
síras 	síras 	NOUN
síribinti	síribinti	VERB[I]
síribinti	síribinti	VERB[T]
síribinti 	síribinti 	VERB[I]
síribinti 	síribinti 	VERB[T]
síro	síro	ADJ
síro	síro	NOUN
síroati	síroati	VERB[T]
sísa	sísa	NOUN
sísari	sísari	NOUN
sísaria	sísaria	NOUN
síwati	síwati	VERB[T]
síyo	síyo	NOUN
síyo 	síyo 	NOUN
sóati	sóati	NOUN
sóati	sóati	VERB[T]
sócota	sócota	ADJ
sóikiiti	sóikiiti	VERB[I]
sóiquiiti	sóiquiiti	VERB[I]
sókota	sókota	ADJ
sóma	sóma	NOUN
sóoiti	sóoiti	VERB[I]
sóro	sóro	NOUN
ta	ta	ADV
ta	ta	NOUN
tachíti	tachíti	VERB[T]
tachóti	tachóti	VERB[T]
tacácho	tacácho	NOUN
tacári	tacári	NOUN
tacáshiti	tacáshiti	NOUN
tacáshiti	tacáshiti	VERB[I]
tahuámpari	tahuámpari	NOUN
tahuásanti	tahuásanti	VERB[T]
tahuín	tahuín	NOUN
tahuínti	tahuínti	NOUN
takácho	takácho	NOUN
takári	takári	NOUN
takáshiti	takáshiti	NOUN
takáshiti	takáshiti	VERB[I]
takéxti	takéxti	VERB[T]
tampéxco	tampéxco	NOUN
tampéxko	tampéxko	NOUN
tampóra	tampóra	NOUN
tampóra 	tampóra 	NOUN
taménooti	taménooti	VERB[I]
taménoti	taménoti	VERB[T]
tan	tan	ADV
tani	tani	ADV
tansóoiti	tansóoiti	VERB[I]
tanéxti	tanéxti	VERB[T]
tapán	tapán	NOUN
tapás	tapás	NOUN
tapásha	tapásha	NOUN
tapó	tapó	ADJ
tapó	tapó	NOUN
tapón	tapón	NOUN
taquéxti	taquéxti	VERB[T]
taráahua	taráahua	NOUN
taráawa	taráawa	NOUN
tarámpa	tarámpa	NOUN
tarámpa 	tarámpa 	NOUN
taránki	taránki	NOUN
taránqui	taránqui	NOUN
taránti	taránti	VERB[T]
taráxti	taráxti	VERB[I]
taréshpi	taréshpi	NOUN
taréti	taréti	VERB[T]
taría	taría	NOUN
tashín ati	tashín ati	VERB[T]
taskéti	taskéti	VERB[I]
tasquéti	tasquéti	VERB[I]
tasá	tasá	NOUN
tasés	tasés	ADJ
tasón	tasón	NOUN
tatínti	tatínti	VERB[T]
tawámpari	tawámpari	NOUN
tawásanti	tawásanti	VERB[T]
tawín	tawín	NOUN
tawínti	tawínti	NOUN
taxbá	taxbá	NOUN
taxcánhuapa	taxcánhuapa	NOUN
taxcónti	taxcónti	VERB[I]
taxkánwapa	taxkánwapa	NOUN
taxkónti	taxkónti	VERB[I]
taxnánti	taxnánti	VERB[T]
taxnáti	taxnáti	VERB[I]
taxtéti	taxtéti	VERB[T]
tayánti	tayánti	VERB[T]
taó	taó	NOUN
tehuánti	tehuánti	VERB[I]
tekiati	tekiati	VERB[T]
tekéiti	tekéiti	VERB[I]
tekéyanti	tekéyanti	VERB[I]
tekí	tekí	NOUN
tekíti	tekíti	VERB[I]
tepáti	tepáti	VERB[I]
tequiati	tequiati	VERB[T]
tequéiti	tequéiti	VERB[I]
tequéyanti	tequéyanti	VERB[I]
tequí	tequí	NOUN
tequíti	tequíti	VERB[I]
terénke	terénke	NOUN
terénque	terénque	NOUN
teskéti	teskéti	VERB[I]
tesquéti	tesquéti	VERB[I]
tesé	tesé	ADJ
tesé	tesé	NOUN
tesés	tesés	ADJ
teséti	teséti	VERB[I]
teté	teté	NOUN
tetón	tetón	NOUN
tetón iti	tetón iti	VERB[I]
tewánti	tewánti	VERB[I]
texcán	texcán	NOUN
texkán	texkán	NOUN
texó	texó	NOUN
teé	teé	NOUN
tian ati	tian ati	VERB[T]
tibíto	tibíto	NOUN
tibíto 	tibíto 	NOUN
ticón	ticón	NOUN
tiibi	tiibi	ADV
tikón	tikón	NOUN
timón	timón	NOUN
tinínhati	tinínhati	VERB[T]
tinínti	tinínti	VERB[I]
tipínti	tipínti	VERB[I]
tirín iti	tirín iti	VERB[I]
tiríti	tiríti	VERB[I]
tií ati	tií ati	VERB[T]
tobánti	tobánti	VERB[T]
tocáyo	tocáyo	NOUN
tocónti	tocónti	VERB[T]
tocóxiti	tocóxiti	VERB[I]
tokáyo	tokáyo	NOUN
tokónti	tokónti	VERB[T]
tokóxiti	tokóxiti	VERB[I]
tomás	tomás	NOUN
tomáya	tomáya	NOUN
tomótomo	tomótomo	NOUN
tonbó	tonbó	NOUN
tonrón	tonrón	NOUN
tonón	tonón	NOUN
tonónkeni	tonónkeni	NOUN
tonónqueni	tonónqueni	NOUN
topónti	topónti	VERB[T]
toráti	toráti	VERB[I]
torísta	torísta	NOUN
toró	toró	ADJ
toró	toró	NOUN
toróati	toróati	VERB[T]
torómpo	torómpo	NOUN
torómpo 	torómpo 	NOUN
toróti	toróti	VERB[I]
toróx	toróx	NOUN
toshbáati	toshbáati	VERB[T]
toshi	toshi	ADV
toshmón	toshmón	ADJ
toshmón	toshmón	NOUN
toshmón ati	toshmón ati	VERB[T]
toshmónti	toshmónti	VERB[T]
toshíti	toshíti	VERB[I]
tosó	tosó	NOUN
tosó 	tosó 	NOUN
tosóti	tosóti	VERB[I]
totísh	totísh	NOUN
totó	totó	ADJ
totó	totó	NOUN
totóti	totóti	VERB[I]
toxbá	toxbá	NOUN
toxbáti	toxbáti	VERB[I]
toxcán	toxcán	NOUN
toxcóti	toxcóti	VERB[I]
toxkán	toxkán	NOUN
toxkóti	toxkóti	VERB[I]
toá	toá	NOUN
toéti	toéti	VERB[I]
toóisma	toóisma	ADJ
toóti	toóti	VERB[I]
tsa	tsa	NOUN
tsamá	tsamá	NOUN
tsamáati	tsamáati	VERB[T]
tsamánti	tsamánti	VERB[T]
tsamáti	tsamáti	VERB[I]
tsancáti	tsancáti	VERB[I]
tsankáti	tsankáti	VERB[I]
tsanás	tsanás	NOUN
tsaníti	tsaníti	VERB[I]
tsanó	tsanó	NOUN
tsaís iti	tsaís iti	VERB[I]
tsaísati	tsaísati	NOUN
tsaísati	tsaísati	VERB[T]
tsaónti	tsaónti	VERB[T]
tsecánti	tsecánti	VERB[T]
tsehué	tsehué	NOUN
tsehuéti	tsehuéti	VERB[I]
tsekánti	tsekánti	VERB[T]
tsekéti	tsekéti	VERB[I]
tsequéti	tsequéti	VERB[I]
tsewé	tsewé	NOUN
tsewéti	tsewéti	VERB[I]
tsi	tsi	ADV
tsikéspoto	tsikéspoto	NOUN
tsimés	tsimés	ADJ
tsimés	tsimés	NOUN
tsinkíti	tsinkíti	NOUN
tsinkíti	tsinkíti	VERB[I]
tsinquíti	tsinquíti	NOUN
tsinquíti	tsinquíti	VERB[I]
tsinó	tsinó	NOUN
tsipán	tsipán	NOUN
tsipís	tsipís	NOUN
tsipísti	tsipísti	VERB[I]
tsiquéspoto	tsiquéspoto	NOUN
tsiscó	tsiscó	NOUN
tsiscóti	tsiscóti	VERB[I]
tsiskó	tsiskó	NOUN
tsiskóti	tsiskóti	VERB[I]
tsismán	tsismán	NOUN
tsispín	tsispín	NOUN
tsispóti	tsispóti	VERB[I]
tsistínti	tsistínti	VERB[T]
tsistó	tsistó	NOUN
tsisó	tsisó	NOUN
tsitsíti	tsitsíti	VERB[I]
tsitsón	tsitsón	NOUN
tsión	tsión	NOUN
tsocás	tsocás	ADJ
tsocásti	tsocásti	VERB[I]
tsokás	tsokás	ADJ
tsokásti	tsokásti	VERB[I]
tson	tson	ADJ
tsonkíro	tsonkíro	NOUN
tsonquíro	tsonquíro	NOUN
tsosá	tsosá	ADJ
tsosá	tsosá	NOUN
tsosáshoco	tsosáshoco	NOUN
tsosáshoko	tsosáshoko	NOUN
tsosí	tsosí	NOUN
tsosín	tsosín	NOUN
tsosínti	tsosínti	VERB[I]
tsosíti	tsosíti	VERB[I]
tsoáhua	tsoáhua	NOUN
tsoáwa	tsoáwa	NOUN
tsoís ati	tsoís ati	VERB[T]
tsoís iti	tsoís iti	VERB[I]
tsáacaati	tsáacaati	VERB[I]
tsáakaati	tsáakaati	VERB[I]
tsáan ati	tsáan ati	VERB[T]
tsáati	tsáati	VERB[T]
tsábe	tsábe	NOUN
tsácacaati	tsácacaati	VERB[I]
tsácanana	tsácanana	NOUN
tsácanananti	tsácanananti	VERB[I]
tsácati	tsácati	VERB[T]
tsáhui	tsáhui	NOUN
tsáiti	tsáiti	VERB[T]
tsákakaati	tsákakaati	VERB[I]
tsákanana	tsákanana	NOUN
tsákanananti	tsákanananti	VERB[I]
tsákati	tsákati	VERB[T]
tsán iti	tsán iti	VERB[T]
tsánimati	tsánimati	VERB[T]
tsáno	tsáno	NOUN
tsáori	tsáori	NOUN
tsáoti	tsáoti	VERB[I]
tsásiati	tsásiati	VERB[T]
tsásimati	tsásimati	VERB[T]
tsásiti	tsásiti	VERB[I]
tsátsa	tsátsa	NOUN
tsátsitaxo	tsátsitaxo	NOUN
tsáwi	tsáwi	NOUN
tsécati	tsécati	VERB[T]
tséhueati	tséhueati	VERB[T]
tsékati	tsékati	VERB[T]
tséweati	tséweati	VERB[T]
tsíhuati	tsíhuati	VERB[T]
tsínaati	tsínaati	VERB[T]
tsínati	tsínati	VERB[I]
tsíniai	tsíniai	NOUN
tsíniainbo	tsíniainbo	NOUN
tsíniati	tsíniati	VERB[T]
tsínicaati	tsínicaati	VERB[I]
tsínikaati	tsínikaati	VERB[I]
tsíniti	tsíniti	VERB[I]
tsíniti	tsíniti	VERB[T]
tsínkiti	tsínkiti	VERB[T]
tsínquiti	tsínquiti	VERB[T]
tsíri	tsíri	ADJ
tsíri	tsíri	NOUN
tsíriti	tsíriti	VERB[I]
tsísa	tsísa	NOUN
tsísati	tsísati	VERB[I]
tsíscoti	tsíscoti	VERB[T]
tsísenen	tsísenen	NOUN
tsískiti	tsískiti	VERB[T]
tsískoti	tsískoti	VERB[T]
tsísoikiti	tsísoikiti	NOUN
tsísoiquiti	tsísoiquiti	NOUN
tsísoti	tsísoti	VERB[I]
tsíspa	tsíspa	ADJ
tsísquiti	tsísquiti	VERB[T]
tsíste	tsíste	NOUN
tsítsimitsa	tsítsimitsa	NOUN
tsítsiti	tsítsiti	VERB[T]
tsíwati	tsíwati	VERB[T]
tsóa	tsóa	PRON
tsóabi	tsóabi	PRON
tsóati	tsóati	VERB[T]
tsómatí	tsómatí	VERB[T]
tsóntsoro	tsóntsoro	NOUN
tsósa	tsósa	NOUN
tsósati	tsósati	VERB[T]
tábara	tábara	NOUN
tábara 	tábara 	NOUN
táca	táca	NOUN
táchiti	táchiti	VERB[T]
tácho	tácho	ADJ
táco	táco	NOUN
táe	táe	NOUN
táe patonco 	táe patonco 	NOUN
táe patonko	táe patonko	NOUN
táechipon	táechipon	NOUN
táemaxca	táemaxca	NOUN
táemaxka	táemaxka	NOUN
táemebi	táemebi	NOUN
táenapax	táenapax	NOUN
táenoacho	táenoacho	NOUN
táenoacho 	táenoacho 	NOUN
táepeca	táepeca	NOUN
táepeka	táepeka	NOUN
táhua	táhua	NOUN
táhui	táhui	NOUN
táka	táka	NOUN
táki	táki	NOUN
táko	táko	NOUN
táma	táma	NOUN
támaxaca	támaxaca	NOUN
támaxaka	támaxaka	NOUN
támo	támo	NOUN
tánacaati	tánacaati	VERB[I]
tánakaati	tánakaati	VERB[I]
tánati	tánati	VERB[T]
táno	táno	ADJ
táno 	táno 	ADJ
tánoti	tánoti	VERB[I]
tánsharina	tánsharina	NOUN
tántimati	tántimati	VERB[T]
tántiti	tántiti	VERB[I]
tányanti	tányanti	VERB[T]
táoskenanti	táoskenanti	VERB[I]
táosquenanti	táosquenanti	VERB[I]
tápiti	tápiti	NOUN
tápo	tápo	NOUN
tápoati	tápoati	NOUN
táqui	táqui	NOUN
tárameeti	tárameeti	VERB[I]
tári	tári	NOUN
táro	táro	ADJ
táronario	táronario	NOUN
táshati	táshati	VERB[T]
táshi	táshi	NOUN
tásoti	tásoti	VERB[T]
tátekeiti	tátekeiti	VERB[I]
tátequeiti	tátequeiti	VERB[I]
táteti	táteti	NOUN
táteti	táteti	VERB[T]
tátitaxo	tátitaxo	NOUN
tátitaxo 	tátitaxo 	NOUN
táwa	táwa	NOUN
táwi	táwi	NOUN
táxa	táxa	NOUN
táxketi	táxketi	VERB[T]
táxo	táxo	NOUN
táxoti	táxoti	VERB[I]
táxqueti	táxqueti	VERB[T]
téamis	téamis	NOUN
téamisti	téamisti	VERB[I]
téati	téati	VERB[T]
técarnis	técarnis	ADJ
técati	técati	VERB[T]
téchapa	téchapa	NOUN
téetai	téetai	NOUN
téeti	téeti	VERB[I]
téeya	téeya	ADJ
téipa	téipa	NOUN
tékarnis	tékarnis	ADJ
tékati	tékati	VERB[T]
ténati	ténati	VERB[T]
téneti	téneti	VERB[T]
ténetima	ténetima	ADJ
téo	téo	NOUN
téoteo	téoteo	NOUN
téoti	téoti	NOUN
téoti	téoti	VERB[T]
tépi	tépi	NOUN
tépicoti	tépicoti	NOUN
tépikoti	tépikoti	NOUN
tépiti	tépiti	NOUN
tépiti	tépiti	VERB[I]
tépochini	tépochini	NOUN
téraca	téraca	NOUN
téraka	téraka	NOUN
tésati	tésati	VERB[T]
tésharanti	tésharanti	NOUN
téshpi	téshpi	NOUN
téxe	téxe	ADJ
téxe	téxe	NOUN
téxeati	téxeati	VERB[T]
téxeti	téxeti	VERB[I]
téxo	téxo	NOUN
téxtecaati	téxtecaati	VERB[I]
téxtekaati	téxtekaati	VERB[I]
téxtemis	téxtemis	NOUN
téxteti	téxteti	VERB[T]
tíati	tíati	NOUN
tíati	tíati	VERB[T]
tíboro	tíboro	NOUN
tímati	tímati	VERB[T]
tímpiro	tímpiro	NOUN
tímpiro 	tímpiro 	NOUN
tínati	tínati	VERB[T]
tínco	tínco	ADJ
tínco	tínco	NOUN
tínko	tínko	ADJ
tínko	tínko	NOUN
tínta	tínta	NOUN
tínta 	tínta 	NOUN
típiti	típiti	VERB[I]
tírico 	tírico 	NOUN
tíriko	tíriko	NOUN
tísati	tísati	VERB[T]
tíshiti	tíshiti	VERB[I]
títa	títa	NOUN
títayoshan	títayoshan	NOUN
títayoshan 	títayoshan 	NOUN
tóati	tóati	NOUN
tóati	tóati	VERB[T]
tóbati	tóbati	VERB[T]
tócari	tócari	NOUN
tócoro	tócoro	NOUN
tócoti	tócoti	VERB[I]
tóeti	tóeti	VERB[T]
tókari	tókari	NOUN
tókoro	tókoro	NOUN
tókoti	tókoti	VERB[I]
tómi	tómi	NOUN
tónco	tónco	NOUN
tóncoati	tóncoati	VERB[T]
tóncomoro	tóncomoro	NOUN
tónko	tónko	NOUN
tónkoati	tónkoati	VERB[T]
tónkomoro	tónkomoro	NOUN
tóoati	tóoati	NOUN
tóoati	tóoati	VERB[T]
tóoiti	tóoiti	VERB[I]
tóoya	tóoya	ADJ
tóoya 	tóoya 	ADJ
tópiti	tópiti	VERB[T]
tópo	tópo	NOUN
tóra	tóra	NOUN
tóro	tóro	NOUN
tórotoroiti	tórotoroiti	VERB[I]
tósha	tósha	NOUN
tóshati	tóshati	VERB[T]
tóshmo	tóshmo	NOUN
tóxpi	tóxpi	NOUN
wa	wa	NOUN
wakán ewa	wakán ewa	NOUN
wakápo	wakápo	NOUN
wakéti	wakéti	VERB[I]
wakín	wakín	NOUN
wan	wan	ADV
wanána	wanána	NOUN
wanín	wanín	NOUN
wanínxenia	wanínxenia	NOUN
wapínkenan	wapínkenan	NOUN
wapóro	wapóro	NOUN
wapóromaxka	wapóromaxka	NOUN
wapóropoinki	wapóropoinki	NOUN
warán	warán	NOUN
waránka	waránka	ADJ
warápo	warápo	NOUN
waróka	waróka	NOUN
warón	warón	ADJ
waróro	waróro	NOUN
washíti	washíti	VERB[T]
wasnón	wasnón	NOUN
wasányakati	wasányakati	NOUN
waxmémpoko	waxmémpoko	NOUN
waxmén	waxmén	NOUN
waxá	waxá	ADJ
waxá	waxá	NOUN
waxáti	waxáti	VERB[I]
waín téetai	waín téetai	NOUN
wekánhati	wekánhati	VERB[T]
wekánti	wekánti	VERB[I]
wekí	wekí	ADJ
wekí	wekí	NOUN
wekíti	wekíti	VERB[I]
wekóti	wekóti	VERB[I]
wentánti	wentánti	VERB[T]
wenén	wenén	NOUN
wenénhati	wenénhati	VERB[T]
wenínti	wenínti	VERB[T]
weníti	weníti	VERB[I]
weránti	weránti	VERB[T]
wesnáti	wesnáti	VERB[I]
westí	westí	ADJ
westíora	westíora	ADJ
westíora ika	westíora ika	NOUN
westíoran jane	westíoran jane	NOUN
wetsa	wetsa	ADV
wetá	wetá	NOUN
wexwéx	wexwéx	NOUN
wexá	wexá	NOUN
wexábita	wexábita	NOUN
wexákais	wexákais	NOUN
wexásama	wexásama	NOUN
wexáti	wexáti	VERB[I]
wexé	wexé	ADJ
wexé	wexé	NOUN
wexéti	wexéti	VERB[I]
weyónti	weyónti	VERB[T]
weyóti	weyóti	NOUN
weyóti	weyóti	VERB[I]
weá	weá	NOUN
weán	weán	NOUN
weíti	weíti	VERB[I]
weóti	weóti	VERB[I]
winkás	winkás	ADJ
winkásti	winkásti	VERB[I]
winónti	winónti	VERB[T]
winóti	winóti	VERB[I]
wirákocha	wirákocha	NOUN
wirísh	wirísh	ADJ
wiríshati	wiríshati	VERB[T]
wiríshti	wiríshti	VERB[I]
wiróx	wiróx	NOUN
wishkónti	wishkónti	NOUN
wishnín	wishnín	NOUN
wishnínti	wishnínti	VERB[I]
wishtín	wishtín	NOUN
wishtín mexoai	wishtín mexoai	NOUN
wishtín paketai	wishtín paketai	NOUN
wishá	wishá	ADJ
wishá	wishá	NOUN
wishí	wishí	ADJ
wishí	wishí	NOUN
wishíti	wishíti	VERB[I]
witá	witá	NOUN
witáx	witáx	NOUN
witóto	witóto	NOUN
wiwán	wiwán	NOUN
wáata	wáata	NOUN
wáati	wáati	VERB[I]
wácho	wácho	ADJ
wáchoati	wáchoati	VERB[T]
wái	wái	NOUN
wái ati	wái ati	VERB[T]
wáiraonti	wáiraonti	NOUN
wáiroro	wáiroro	NOUN
wáiti	wáiti	NOUN
wáiwanti	wáiwanti	NOUN
wáka	wáka	NOUN
wákabake	wákabake	NOUN
wákabene	wákabene	NOUN
wákanawa	wákanawa	NOUN
wákaxoma	wákaxoma	NOUN
wáketi	wáketi	VERB[T]
wáki	wáki	NOUN
wáko	wáko	NOUN
wáme	wáme	NOUN
wámebero	wámebero	NOUN
wáno	wáno	NOUN
wánomaati	wánomaati	VERB[T]
wánooma	wánooma	ADJ
wánoti	wánoti	NOUN
wánoti	wánoti	VERB[I]
wánoya	wánoya	ADJ
wánta	wánta	NOUN
wáoati	wáoati	VERB[T]
wáoiti	wáoiti	VERB[I]
wápa	wápa	NOUN
wápawapa	wápawapa	NOUN
wápi	wápi	NOUN
wárakeni	wárakeni	NOUN
wárawasko	wárawasko	NOUN
wári	wári	NOUN
wása	wása	NOUN
wásameeti	wásameeti	VERB[I]
wásananto	wásananto	NOUN
wásanti	wásanti	VERB[T]
wási	wási	NOUN
wásikaman chiáxka	wásikaman chiáxka	NOUN
wásimanan	wásimanan	NOUN
wáste	wáste	NOUN
wáxati	wáxati	VERB[T]
wéa	wéa	NOUN
wéati	wéati	VERB[T]
wémekaati	wémekaati	VERB[I]
wémeti	wémeti	VERB[T]
wéntameeti	wéntameeti	VERB[I]
wéonti	wéonti	VERB[T]
wérameeti	wérameeti	VERB[I]
wére	wére	ADJ
wésna	wésna	NOUN
wésnati	wésnati	VERB[T]
wétsa	wétsa	ADJ
wétsa	wétsa	NOUN
wétsa bakísh	wétsa bakísh	ADV
wéxakaati	wéxakaati	VERB[I]
wéxati	wéxati	NOUN
wéxati	wéxati	VERB[T]
wéxet	wéxet	VERB[T]
wía	wía	ADJ
wíaati	wíaati	VERB[T]
wíati	wíati	VERB[I]
wíikiti	wíikiti	VERB[I]
wínati	wínati	VERB[T]
wíni	wíni	ADJ
wíniti	wíniti	VERB[T]
wíno	wíno	NOUN
wínoti	wínoti	VERB[T]
wínti	wínti	NOUN
wípoko	wípoko	NOUN
wírita	wírita	NOUN
wísati	wísati	VERB[T]
wíshati	wíshati	VERB[T]
wíshmabaon tapán	wíshmabaon tapán	NOUN
wíshmabo	wíshmabo	NOUN
wíshpo	wíshpo	NOUN
wíshtininti	wíshtininti	NOUN
wísiti	wísiti	VERB[I]
wískiti	wískiti	VERB[I]
wíso	wíso	ADJ
wíso	wíso	NOUN
wísoati	wísoati	VERB[T]
wísobimi	wísobimi	NOUN
wísoti	wísoti	VERB[T]
xa	xa	NOUN
xabhán huarán	xabhán huarán	NOUN
xabhán warán	xabhán warán	NOUN
xabá	xabá	NOUN
xacá	xacá	NOUN
xacácharo	xacácharo	NOUN
xahuán	xahuán	NOUN
xahuén báque xói	xahuén báque xói	NOUN
xaháati	xaháati	VERB[T]
xaká	xaká	NOUN
xakácharo	xakácharo	NOUN
xampósha	xampósha	NOUN
xanbán	xanbán	NOUN
xanbín	xanbín	NOUN
xancón	xancón	NOUN
xanhnéxti	xanhnéxti	VERB[T]
xankén	xankén	NOUN
xankón	xankón	NOUN
xanquén	xanquén	NOUN
xanshán iti	xanshán iti	VERB[I]
xantó	xantó	NOUN
xaná	xaná	NOUN
xanén	xanén	NOUN
xaní	xaní	NOUN
xanínya	xanínya	NOUN
xaran	xaran	POSTP
xará iti	xará iti	VERB[I]
xarára	xarára	NOUN
xatán	xatán	NOUN
xaté	xaté	ADJ
xaté	xaté	NOUN
xatéti	xatéti	VERB[I]
xawán	xawán	NOUN
xawén báke xói	xawén báke xói	NOUN
xaén mapán	xaén mapán	NOUN
xaén meyari	xaén meyari	NOUN
xebicá	xebicá	NOUN
xebiká	xebiká	NOUN
xebón	xebón	NOUN
xehuínti	xehuínti	VERB[T]
xeké	xeké	NOUN
xená	xená	ADJ
xenán	xenán	NOUN
xepán	xepán	NOUN
xepóti	xepóti	NOUN
xepóti	xepóti	VERB[I]
xepóx	xepóx	NOUN
xepóx 	xepóx 	NOUN
xequé	xequé	NOUN
xesháya	xesháya	NOUN
xetín	xetín	ADJ
xewínti	xewínti	VERB[T]
xexé	xexé	NOUN
xexón	xexón	NOUN
xeyóti	xeyóti	VERB[T]
xocóti	xocóti	VERB[I]
xokóti	xokóti	VERB[I]
xomóx	xomóx	NOUN
xon	xon	ADV
xonxín iti	xonxín iti	VERB[I]
xoná	xoná	NOUN
xonán	xonán	NOUN
xonánti	xonánti	VERB[I]
xonón née	xonón née	NOUN
xopán	xopán	NOUN
xopó	xopó	ADJ
xotó	xotó	NOUN
xotónti	xotónti	VERB[T]
xoxáxte	xoxáxte	NOUN
xoá	xoá	ADJ
xoánti	xoánti	VERB[T]
xoáti	xoáti	VERB[I]
xoó	xoó	ADJ
xábati	xábati	VERB[I]
xábi	xábi	NOUN
xáchi	xáchi	NOUN
xáchiti	xáchiti	VERB[I]
xáco	xáco	NOUN
xáe	xáe	NOUN
xáhue	xáhue	NOUN
xáhui	xáhui	NOUN
xákiti	xákiti	NOUN
xákiti	xákiti	VERB[T]
xáko	xáko	NOUN
xáma	xáma	NOUN
xána	xána	ADJ
xána	xána	NOUN
xánaati	xánaati	VERB[T]
xánati	xánati	VERB[I]
xánbo	xánbo	NOUN
xáne	xáne	NOUN
xáneoto	xáneoto	NOUN
xáni	xáni	NOUN
xáo	xáo	NOUN
xápo	xápo	NOUN
xáquiti	xáquiti	NOUN
xáquiti	xáquiti	VERB[T]
xára	xára	NOUN
xáta	xáta	NOUN
xáte	xáte	NOUN
xáteti	xáteti	VERB[T]
xáwe	xáwe	NOUN
xáwi	xáwi	NOUN
xáxa	xáxa	ADJ
xáxati	xáxati	VERB[T]
xáxo	xáxo	NOUN
xéati	xéati	NOUN
xéati	xéati	VERB[I]
xébi	xébi	NOUN
xébiana	xébiana	NOUN
xébichi	xébichi	NOUN
xéblkexa	xéblkexa	NOUN
xéblquexa	xéblquexa	NOUN
xéca	xéca	NOUN
xécabimi	xécabimi	NOUN
xécha	xécha	ADJ
xéchokiiti	xéchokiiti	NOUN
xéchokiiti	xéchokiiti	VERB[I]
xéchoquiiti	xéchoquiiti	NOUN
xéchoquiiti	xéchoquiiti	VERB[I]
xéco	xéco	NOUN
xéhuati	xéhuati	VERB[T]
xéiti	xéiti	VERB[T]
xéka	xéka	NOUN
xékabimi	xékabimi	NOUN
xéki	xéki	NOUN
xékitoxkan	xékitoxkan	NOUN
xéko	xéko	NOUN
xémacayan	xémacayan	NOUN
xémakayan	xémakayan	NOUN
xémeti	xémeti	VERB[T]
xéna	xéna	NOUN
xénche	xénche	ADJ
xéni	xéni	NOUN
xéniati	xéniati	NOUN
xéno	xéno	NOUN
xénto	xénto	ADJ
xépishiti	xépishiti	VERB[T]
xépocooti	xépocooti	VERB[I]
xépokooti	xépokooti	VERB[I]
xépoti	xépoti	VERB[T]
xéqui	xéqui	NOUN
xéquitoxcan	xéquitoxcan	NOUN
xérebo	xérebo	NOUN
xéshpi	xéshpi	NOUN
xéta	xéta	NOUN
xéta tapón	xéta tapón	NOUN
xétaoma	xétaoma	ADJ
xétaya	xétaya	ADJ
xéte	xéte	NOUN
xétebo	xétebo	NOUN
xéteti	xéteti	VERB[T]
xéto	xéto	NOUN
xéwati	xéwati	VERB[T]
xéyocooti	xéyocooti	VERB[I]
xéyokooti	xéyokooti	VERB[I]
xóa	xóa	NOUN
xóati	xóati	VERB[I]
xóbi	xóbi	NOUN
xóbo	xóbo	NOUN
xóbocon	xóbocon	NOUN
xóbokon	xóbokon	NOUN
xóbomaxca	xóbomaxca	NOUN
xóbomaxka	xóbomaxka	NOUN
xóbopeca	xóbopeca	NOUN
xóbopeka	xóbopeka	NOUN
xócati	xócati	VERB[T]
xóchi	xóchi	NOUN
xói	xói	ADJ
xói	xói	NOUN
xóiti	xóiti	VERB[T]
xókati	xókati	VERB[T]
xóke	xóke	NOUN
xóma	xóma	NOUN
xómi	xómi	NOUN
xónioro	xónioro	NOUN
xóno	xóno	NOUN
xóntaco	xóntaco	NOUN
xóntako	xóntako	NOUN
xónxo	xónxo	NOUN
xóon ati	xóon ati	VERB[T]
xóon iti	xóon iti	VERB[I]
xópishi	xópishi	NOUN
xóque	xóque	NOUN
xóra	xóra	NOUN
xóro	xóro	NOUN
xóxo	xóxo	NOUN
xóxoai jahuéqui	xóxoai jahuéqui	NOUN
xóxoai jawéki	xóxoai jawéki	NOUN
xóxobake	xóxobake	NOUN
xóxobaque	xóxobaque	NOUN
xóxoti	xóxoti	VERB[I]
xóya	xóya	NOUN
ya	ya	POSTP
ya	ya	NOUN
yabínti	yabínti	VERB[T]
yacámati	yacámati	VERB[T]
yacáti	yacáti	NOUN
yacáti	yacáti	VERB[I]
yahuámasen	yahuámasen	NOUN
yahuísh	yahuísh	NOUN
yakámati	yakámati	VERB[T]
yakáti	yakáti	NOUN
yakáti	yakáti	VERB[I]
yakíati	yakíati	VERB[T]
yakíti	yakíti	VERB[I]
yamé	yamé	ADV
yamé	yamé	NOUN
yamékiri	yamékiri	ADV
yamékirishoko	yamékirishoko	ADV
yamékirishoko	yamékirishoko	VERB[I]
yaméquiri	yaméquiri	ADV
yaméquirishoco	yaméquirishoco	ADV
yaméquirishoco	yaméquirishoco	VERB[I]
yamín téetai	yamín téetai	NOUN
yancháma	yancháma	NOUN
yancón	yancón	ADJ
yancón oxna	yancón oxna	ADJ
yancón paxna	yancón paxna	ADJ
yankón	yankón	ADJ
yankón oxna	yankón oxna	ADJ
yankón paxna	yankón paxna	ADJ
yantán	yantán	ADV
yantáncainai	yantáncainai	ADV
yantánkainai	yantánkainai	ADV
yantánpake	yantánpake	ADV
yantánpaque	yantánpaque	ADV
yantánti	yantánti	VERB[I]
yantányora	yantányora	ADV
yapá	yapá	NOUN
yapán ehua	yapán ehua	NOUN
yapán ewa	yapán ewa	NOUN
yaquíati	yaquíati	VERB[T]
yaquíti	yaquíti	VERB[I]
yasánti	yasánti	VERB[T]
yatámati	yatámati	VERB[T]
yatánti	yatánti	VERB[T]
yawámasen	yawámasen	NOUN
yawísh	yawísh	NOUN
yenkén	yenkén	ADJ
yenquén	yenquén	ADJ
yobán	yobán	NOUN
yobé	yobé	NOUN
yobémis	yobémis	NOUN
yobénti	yobénti	VERB[I]
yobéti	yobéti	NOUN
yobín	yobín	NOUN
yocá	yocá	NOUN
yocámis	yocámis	NOUN
yocámisti	yocámisti	VERB[I]
yocáti	yocáti	VERB[T]
yoká	yoká	NOUN
yokámis	yokámis	NOUN
yokámisti	yokámisti	VERB[I]
yokáti	yokáti	VERB[T]
yokíti	yokíti	VERB[I]
yomán	yomán	NOUN
yomán ati	yomán ati	VERB[T]
yomán ati 	yomán ati 	VERB[T]
yomén	yomén	NOUN
yon	yon	ADV
yonshín	yonshín	NOUN
yoná	yoná	NOUN
yonán	yonán	ADJ
yonán	yonán	NOUN
yonánti	yonánti	VERB[T]
yonánti 	yonánti 	VERB[T]
yonína	yonína	NOUN
yonó	yonó	NOUN
yonóti	yonóti	VERB[I]
yopána	yopána	NOUN
yoquíti	yoquíti	VERB[I]
yora	yora	NOUN
yora 	yora 	NOUN
yorónti	yorónti	VERB[I]
yoshín	yoshín	NOUN
yoshínbake	yoshínbake	NOUN
yoshínbaon coshi	yoshínbaon coshi	NOUN
yoshínbaon koshi	yoshínbaon koshi	NOUN
yoshínbaque	yoshínbaque	NOUN
yoshíncoshqui	yoshíncoshqui	NOUN
yoshínhati	yoshínhati	VERB[T]
yoshínkoshki	yoshínkoshki	NOUN
yoshíntete	yoshíntete	NOUN
yoshínti	yoshínti	VERB[I]
yoshínxatan	yoshínxatan	NOUN
yoshínxatan 	yoshínxatan 	NOUN
yotán	yotán	NOUN
yotéca	yotéca	NOUN
yotéka	yotéka	NOUN
yotéti	yotéti	VERB[I]
yotó	yotó	NOUN
yoxán	yoxán	ADJ
yoxán	yoxán	NOUN
yoyóti	yoyóti	VERB[T]
yoá	yoá	NOUN
yoá acai	yoá acai	NOUN
yoá akai	yoá akai	NOUN
yoá ati	yoá ati	VERB[T]
yoímis	yoímis	ADJ
yoínti	yoínti	VERB[T]
yoóti	yoóti	VERB[I]
yáan	yáan	NOUN
yácoa	yácoa	NOUN
yáe	yáe	NOUN
yáhua	yáhua	NOUN
yáhuaranqui	yáhuaranqui	NOUN
yáhuishan ehua	yáhuishan ehua	NOUN
yákoa	yákoa	NOUN
yáma	yáma	ADV
yáma	yáma	NOUN
yámati	yámati	VERB[I]
yámecan ehua	yámecan ehua	NOUN
yámekan ewa	yámekan ewa	NOUN
yámi	yámi	NOUN
yámi boi	yámi boi	NOUN
yámichacati	yámichacati	NOUN
yámichakati	yámichakati	NOUN
yámichopa	yámichopa	NOUN
yámikenti	yámikenti	NOUN
yáminahua	yáminahua	NOUN
yáminawa	yáminawa	NOUN
yámipoi	yámipoi	NOUN
yámiquenti	yámiquenti	NOUN
yámixakiti	yámixakiti	NOUN
yámixaquiti	yámixaquiti	NOUN
yámixeta	yámixeta	NOUN
yámixoiti	yámixoiti	NOUN
yánca	yánca	ADV
yáncama	yáncama	ADJ
yánka	yánka	ADV
yánkama	yánkama	ADJ
yápa	yápa	NOUN
yáwa	yáwa	NOUN
yáwaranki	yáwaranki	NOUN
yáwishan ewa	yáwishan ewa	NOUN
yáya	yáya	NOUN
yáya 	yáya 	NOUN
yénshiti	yénshiti	VERB[T]
yéxketi	yéxketi	VERB[T]
yéxqueti	yéxqueti	VERB[T]
yóashi	yóashi	ADJ
yóashiti	yóashiti	VERB[I]
yócata joi	yócata joi	NOUN
yóchi	yóchi	NOUN
yóia	yóia	NOUN
yóia joi	yóia joi	NOUN
yóimeeti	yóimeeti	VERB[I]
yóimis	yóimis	NOUN
yóina	yóina	NOUN
yóiti	yóiti	ADJ
yóiti	yóiti	VERB[T]
yóiti iti	yóiti iti	VERB[I]
yóitima	yóitima	ADJ
yóitimati	yóitimati	VERB[I]
yókata joi	yókata joi	NOUN
yómerati	yómerati	VERB[T]
yómetsoati	yómetsoati	VERB[T]
yómetsoti	yómetsoti	VERB[I]
yómoxo	yómoxo	NOUN
yómpa	yómpa	NOUN
yónaati	yónaati	VERB[T]
yónki	yónki	NOUN
yóno	yóno	NOUN
yónoti	yónoti	VERB[T]
yónoti joi	yónoti joi	NOUN
yónotima	yónotima	ADJ
yónqui	yónqui	NOUN
yópa	yópa	NOUN
yópatati	yópatati	NOUN
yópati	yópati	VERB[I]
yóra	yóra	NOUN
yóshiman boéxeti	yóshiman boéxeti	NOUN
yóshiman páxokiriti	yóshiman páxokiriti	NOUN
yóshiman páxoquiriti 	yóshiman páxoquiriti 	NOUN
yóshoti	yóshoti	VERB[T]
yóshpe	yóshpe	NOUN
yósi	yósi	ADJ
yósi	yósi	NOUN
yósiati	yósiati	VERB[T]
yósishoco	yósishoco	NOUN
yósishoko	yósishoko	NOUN
yósiti	yósiti	VERB[I]
yósma	yósma	ADJ
yóti	yóti	NOUN
yótoti	yótoti	VERB[T]
yóyo iti	yóyo iti	VERB[I]
yóyocooti	yóyocooti	VERB[I]
yóyokooti	yóyokooti	VERB[I]
ábion	ábion	NOUN
ábo	ábo	NOUN
ábocoma	ábocoma	NOUN
ábokoma	ábokoma	NOUN
áchi	áchi	NOUN
áchi 	áchi 	NOUN
áco	áco	ADJ
ácoron	ácoron	NOUN
ácoti	ácoti	VERB[I]
ácotiri	ácotiri	NOUN
áhuai	áhuai	NOUN
áhuarampiti 	áhuarampiti 	NOUN
áko	áko	ADJ
ákoron	ákoron	NOUN
ákoti	ákoti	VERB[I]
ákotiri	ákotiri	NOUN
ámakiri	ámakiri	NOUN
ámaquiri	ámaquiri	NOUN
ámati	ámati	VERB[T]
ámatianbi	ámatianbi	ADV
ámican ehua	ámican ehua	NOUN
ámikan ewa	ámikan ewa	NOUN
áni	áni	ADJ
áni xéati	áni xéati	NOUN
ániati	ániati	VERB[T]
ánibó	ánibó	NOUN
ánicochara	ánicochara	NOUN
ánijema	ánijema	NOUN
ánikochara	ánikochara	NOUN
ánima	ánima	ADJ
ánimai	ánimai	NOUN
ánimanan	ánimanan	NOUN
ániparo	ániparo	NOUN
ániti	ániti	VERB[I]
ánjiri	ánjiri	NOUN
áno	áno	NOUN
ánsiano	ánsiano	ADJ
ánsiano	ánsiano	NOUN
ánta	ánta	NOUN
ánticoo 	ánticoo 	ADJ
ántikoo	ántikoo	ADJ
ántiojo	ántiojo	NOUN
ápacharan	ápacharan	NOUN
ápaketi	ápaketi	VERB[T]
ápaqueti	ápaqueti	VERB[T]
ápasahua	ápasahua	NOUN
ápasawa	ápasawa	NOUN
ápashiro	ápashiro	NOUN
ápichiro	ápichiro	NOUN
ápichiro 	ápichiro 	NOUN
ápo	ápo	NOUN
ára	ára	ADJ
ára	ára	NOUN
áraati	áraati	VERB[T]
árapa	árapa	NOUN
árapa 	árapa 	NOUN
árati	árati	VERB[I]
áresti	áresti	VERB[T]
árihua	árihua	NOUN
áriman	áriman	NOUN
árimintanti	árimintanti	VERB[T]
árimintanti 	árimintanti 	VERB[T]
áriwa	áriwa	NOUN
áshpa	áshpa	ADJ
ásiitona	ásiitona	NOUN
áspa	áspa	ADJ
átapa	átapa	NOUN
átapaahuin	átapaahuin	NOUN
átapaawin	átapaawin	NOUN
átapabene	átapabene	NOUN
áti	áti	VERB[T]
áticoma	áticoma	ADJ
áticoma jahuequi	áticoma jahuequi	NOUN
átikoma	átikoma	ADJ
átikoma jaweki	átikoma jaweki	NOUN
átio	átio	ADV
átipanti	átipanti	VERB[I]
átipanti	átipanti	VERB[T]
átsa	átsa	NOUN
áwai	áwai	NOUN
áwarampiti	áwarampiti	NOUN
áxa	áxa	NOUN
áxeamis	áxeamis	NOUN
áxeati	áxeati	VERB[T]
áxeti	áxeti	VERB[I]
áxeyosma	áxeyosma	NOUN
áxo	áxo	NOUN
áya	áya	ADJ
áya	áya	NOUN
áyahuasca	áyahuasca	NOUN
áyawaska	áyawaska	NOUN
émo	émo	NOUN
émoti	émoti	VERB[I]
éniti	éniti	VERB[I]
épa	épa	NOUN
ésecaati	ésecaati	VERB[I]
ésekaati	ésekaati	VERB[I]
éseti	éseti	VERB[T]
éshi	éshi	NOUN
éste	éste	ADJ
ésteati	ésteati	VERB[T]
ésteti	ésteti	VERB[I]
étse	étse	NOUN
éxpa	éxpa	ADJ
éxpaati	éxpaati	VERB[T]
éxpati	éxpati	VERB[I]
í	í	ADV
ía	ía	NOUN
íajexe	íajexe	NOUN
íamax	íamax	ADV
íbirio joi	íbirio joi	NOUN
íbirio joi 	íbirio joi 	NOUN
íbiriojoni	íbiriojoni	NOUN
íbiriojoni 	íbiriojoni 	NOUN
íbiti	íbiti	VERB[I]
íbo	íbo	NOUN
íboati	íboati	VERB[T]
íboati 	íboati 	VERB[T]
ícai itan acai joi	ícai itan acai joi	NOUN
ícha	ícha	ADJ
íchama	íchama	ADJ
ícobimi 	ícobimi 	NOUN
ícojihui 	ícojihui 	NOUN
íconi	íconi	ADV
íhue	íhue	ADJ
íhue	íhue	NOUN
íhueati	íhueati	VERB[T]
íhueti	íhueti	VERB[I]
íhueti	íhueti	VERB[T]
íhui	íhui	NOUN
íhuica	íhuica	NOUN
íhuichiex	íhuichiex	NOUN
íiro	íiro	NOUN
íjirisisio	íjirisisio	NOUN
íjirisisio 	íjirisisio 	NOUN
íkai itan akai joi	íkai itan akai joi	NOUN
íki	íki	NOUN
íkirisia	íkirisia	NOUN
íkobimi	íkobimi	NOUN
íkojiwi	íkojiwi	NOUN
íkoni	íkoni	ADV
ímati	ímati	VERB[T]
ímoshiiti	ímoshiiti	VERB[I]
ímpaniti	ímpaniti	VERB[I]
ímpekeeti	ímpekeeti	VERB[I]
ímpequeeti	ímpequeeti	VERB[I]
ínca	ínca	NOUN
íncajoi 	íncajoi 	NOUN
íncashiminbo	íncashiminbo	NOUN
ínchokiiti	ínchokiiti	VERB[I]
ínchoquiiti	ínchoquiiti	VERB[I]
ínchoshiiti	ínchoshiiti	VERB[I]
íni	íni	NOUN
íni 	íni 	NOUN
ínjiniro	ínjiniro	NOUN
ínka	ínka	NOUN
ínkajoi	ínkajoi	NOUN
ínkashiminbo	ínkashiminbo	NOUN
íno	íno	NOUN
ínoaxatan	ínoaxatan	NOUN
ínojihui	ínojihui	NOUN
ínojihui resénbi	ínojihui resénbi	NOUN
ínojiwi	ínojiwi	NOUN
ínojiwi resénbi	ínojiwi resénbi	NOUN
ínomentsis	ínomentsis	NOUN
ínspi	ínspi	NOUN
ínstitosion	ínstitosion	NOUN
íntoshiiti	íntoshiiti	VERB[I]
íntsacaati	íntsacaati	VERB[I]
íntsakaati	íntsakaati	VERB[I]
ínxoti	ínxoti	VERB[T]
ínxpe	ínxpe	ADJ
íoti	íoti	VERB[T]
ípaketi	ípaketi	VERB[T]
ípaqueti	ípaqueti	VERB[T]
ípo	ípo	NOUN
ípoati	ípoati	NOUN
ípopotamo	ípopotamo	NOUN
íporoni	íporoni	NOUN
íporoni 	íporoni 	NOUN
íqui	íqui	NOUN
íquirisia	íquirisia	NOUN
íracanti	íracanti	NOUN
írakanti	írakanti	NOUN
íresa jahuéqui	íresa jahuéqui	NOUN
íresa jawéki	íresa jawéki	NOUN
írijanti	írijanti	NOUN
írijanti 	írijanti 	NOUN
írimana	írimana	NOUN
írimano	írimano	NOUN
ísa	ísa	NOUN
ísarairita	ísarairita	NOUN
ísarairita 	ísarairita 	NOUN
ísco	ísco	NOUN
íscoira 	íscoira 	NOUN
íscojina	íscojina	NOUN
íscon	íscon	ADJ
íshiiti	íshiiti	VERB[I]
íshori icai	íshori icai	NOUN
íshori ikai	íshori ikai	NOUN
íshto	íshto	ADJ
íshto	íshto	ADV
íshtoma	íshtoma	NOUN
íshtoti	íshtoti	VERB[I]
ísko	ísko	NOUN
ískoira	ískoira	NOUN
ískojina	ískojina	NOUN
ískon	ískon	ADJ
íso	íso	NOUN
ísocoro 	ísocoro 	NOUN
ísokoro	ísokoro	NOUN
ísoxeta	ísoxeta	NOUN
íspi	íspi	NOUN
ísti	ísti	NOUN
ístiroja	ístiroja	NOUN
ístiroja 	ístiroja 	NOUN
íti	íti	NOUN
íti	íti	VERB[I]
ítima	ítima	ADJ
ítsa	ítsa	ADJ
íwe	íwe	ADJ
íwe	íwe	NOUN
íweati	íweati	VERB[T]
íweti	íweti	VERB[I]
íweti	íweti	VERB[T]
íwi	íwi	NOUN
íwichiex	íwichiex	NOUN
íwika	íwika	NOUN
íxme	íxme	ADJ
óa	óa	ADJ
óa	óa	PRON
óbabimi	óbabimi	NOUN
óbahuai	óbahuai	NOUN
óbanishi	óbanishi	NOUN
óbawai	óbawai	NOUN
óca	óca	NOUN
ócha	ócha	NOUN
óchaatima	óchaatima	ADJ
óchaoma	óchaoma	ADJ
óchati	óchati	VERB[I]
óchaya	óchaya	NOUN
ócoti	ócoti	VERB[I]
óe	óe	ADJ
ói	ói	NOUN
óimeeti	óimeeti	VERB[I]
óipoa	óipoa	NOUN
óishoro	óishoro	NOUN
óiti	óiti	VERB[T]
óixehua	óixehua	NOUN
óixewa	óixewa	NOUN
óka	óka	NOUN
óke	óke	ADV
ókoti	ókoti	VERB[I]
ómaati	ómaati	VERB[T]
ómati	ómati	VERB[I]
ómo	ómo	ADJ
ónacaati	ónacaati	VERB[I]
ónakaati	ónakaati	VERB[I]
ónameeti	ónameeti	VERB[I]
ónati	ónati	VERB[T]
óni	óni	NOUN
ónibirisitara	ónibirisitara	NOUN
ónibirisitara 	ónibirisitara 	NOUN
ónitsapishoco	ónitsapishoco	ADJ
ónitsapishoko	ónitsapishoko	ADJ
ónitsapiti	ónitsapiti	VERB[I]
ónitsati	ónitsati	VERB[I]
ónno	ónno	ADV
óno	óno	ADV
ónsatanti	ónsatanti	VERB[I]
óque	óque	ADV
óra	óra	NOUN
óra acai	óra acai	NOUN
óra akai	óra akai	NOUN
óracanisasion 	óracanisasion 	NOUN
órakanisasion	órakanisasion	NOUN
órasion	órasion	NOUN
óri	óri	ADV
óri	óri	POSTP
óro	óro	NOUN
órono	órono	NOUN
órono 	órono 	NOUN
óroti	óroti	VERB[T]
ósameeti	ósameeti	VERB[I]
óscoosco	óscoosco	NOUN
óshi	óshi	ADJ
óshiti	óshiti	VERB[I]
óskoosko	óskoosko	NOUN
óso	óso	NOUN
óstameeti	óstameeti	VERB[I]
óta	óta	NOUN
ótaati	ótaati	VERB[T]
ótati	ótati	VERB[I]
ótexeeti	ótexeeti	VERB[I]
ótexeeti 	ótexeeti 	VERB[I]
ótocoro	ótocoro	NOUN
ótokoro	ótokoro	NOUN
ótoronco	ótoronco	NOUN
ótoronko	ótoronko	NOUN
ótsiati	ótsiati	VERB[T]
ótsiti.	ótsiti.	VERB[I]
óxacasti	óxacasti	VERB[I]
óxakasti	óxakasti	VERB[I]
óxati	óxati	NOUN
óxati	óxati	VERB[I]
óxe	óxe	NOUN
óyocaati	óyocaati	VERB[I]
óyokaati	óyokaati	VERB[I]
óyoti	óyoti	VERB[T]
