chonka	chonka	NUM 
chosko	chosko	NUM 
jábicho	jábicho	NUM 
kimisha	kimisha	NUM 
kimisha 	kimisha 	NUM 
pacha	pacha	NUM 
pichika	pichika	NUM 
posaka	posaka	NUM 
pácha	pácha	NUM 
rabera	rabe	NUM ra[EV]
rabeten	rabe	NUM ten[ERG]
rabé	rabé	NUM 
rabéribi	rabé	NUM ribi[ADV]
rabéki	rabé	NUM ki[INT]
rabékan	rabé	NUM kan[ERG]
sokota	sokota	NUM 
sudamérica	sudamérica	NUM 
westiorabi	westiora	NUM bi[EM]
westiora	westiora	NUM 
westíora	westíora	NUM 
westíorai	westíora	NUM i[SDSS]
